a meaning beyond themselves :   ma'nâ-i harfî
a most excellent pattern :   ahsan-i taqwîm
a worshipped one :   ma'bûd
abd al-qahir jurjani :   Abdulqâhir-i Jurjânî
ablution :   wudû’
ablutions :   wudû’
abode of felicity :   dâr sa'âdah
abraham :   Ibrahîm, Ibrâhîm
abraham (peace be upon him) :   Ibrahîm alayhissalâm
absoltely all-wise one :   Hakîm-i Mutlaq
absolute :   mutlaq,  Mutlaq
absolute beauty :   jamâl mutlaqah
absolute bestower :   Fayyâz-i Mutlaq
absolute certainty :   haqq’al-yaqîn,  haqqalyaqîn,  haqqalyaqîn,  haqqalyaqîn
absolute certainty' :   haqqalyaqîn
absolute commander :   Âmir­i Mutlaq
absolute justice :   'adâlat mutlaqah
absolute mercy :   rahmat mutlaqah
absolute object of worship :   Ma'bûd-u Mutlaq
absolute power :   qudrat mutlaqah
absolute powerful one :   Qadîr-i Mutlaq
absolute powerful one of glory :   Qadîr-i Zuljalâl
absolute ruler :   Hâkim-i Mutlaq,  Hâkim-i Mutlaq
absolute strength :   Qawiyy-i Mutlaq
absolutely all-hearing :   Samî'-i Mutlaq
absolutely compassionate :   Rahîm-i Mutlaq
absolutely compassionate one :   Rahîm-i Mutlaq
absolutely generous :   Karîm-i Mutlaq
absolutely generous one :   Almighty Karîm-i Mutlaq, Jawwâd-i Mutlaq,  Jawwâd-i Mutlaq, Karîm-i Mutlaq
absolutely just one :    'âdil-i Mutlaq
absolutely knowing :    'Alîm-i Mutlaq
absolutely knowing one :    'Alîm-i Mutlaq
absolutely merciful one :   Rahîm-i Mutlaq
absolutely obedient creatures :   slaves of Allah
absolutely omnipotent one :   Qadîr-i Mutlaq
absolutely perfect one :   Kamâl-i Mutlaq
absolutely powerful :   Qadîr-i Mutlaq,  Qadîr-i Mutlaq
absolutely powerful one :   Qadîr Mutlaq,  Qadîr-i Mutlaq,  Qadîr-i Mutlaq,   Qadîr-i Mutlaq,  Qadîr-i Mutlaq
absolutely self-sufficient :   Ghaniyy-i Ala'l-itlaq
absolutely wise :   Hakîm-i Mutlaq
absolutely wise one :   Hakîm-i Mutlaq,   Hakîm-i Mutlaq
absolutely without need :   Mustaghnî­i 'Ala'l­itlaq
absolutly powerful :   Qadîr-i Mutlaq
abu al-'ala al-ma'arri :   Abu'l-'Alâ-i Ma'arrî
abu bakr the veracious :   Abubakir-i Siddîq
abu hanifa :   Abu Hanîfah
abu jahl :   Abu Jahil
abu talib :   Abu Tâlib
abundance :   barakah
abuse :   shatm
act :    'amal, fi’l
action :    'amal, fi’l
actions :   a'mâl, ef’âl
acts :   a'mâl, ef’âl,  fa’aliyyat
adam :    dem,  dam,   dam alayhissalâm,  dam, âdam,  âdam,  dam
adam (peace be upon him) :    dam alayhissalâm
administering :   idârah
administrator :   Mudabbir
admiration :   madh
adorned :   muzayyan
adorner :   Muzayyin
adornment :   muzayyan,  zînat
affirm :   do tasdîq
affirmation :   tasdîq
affirmation of divine unity :   TAWHÎD,  tawhîd,  tawhîd,  tawhîd
affirmation of god :   tawhîd
affirmation of unity of divine dominicality :   tawhîd-i rubûbiyyah
affirmation of unity of divine glory :   tawhîd-i jalâlî
affirmation of unity of divine self-subsistence :   tawhîd-i qayyûmiyyah
affirmation of unity of the godhead :   tawhîd-i ulûhiyyah
afternoon :    'asr
age :   ‘asr
agent :   Dzat,  fâil
ah! it is he! :   Hây Khûy
ahl al-sunna wa'l-jama'at :   Ahl-i Sunnah wal Jamâ'ah
al-fatiha :   al-Fatihah,  Fâtihah
al-ghazzali :   Imâm­i Ghazâlî
al-hamdulillah :   Alhamdulillâh
al-mu'allaqat al-sab'a :   Mu'allaqât-i Sab'ah
al-wise creator :   Fâtir-i Hakîm
alif :   alif
all-beauteous and glorious one :   Jamîl-i Zuljalâl,  Jalîl-i Jamil
all-beauteous builder :   Bâni-i Zuljamâl
all-beauteous creator :   Fâtir-i Zuljamâl
all-beauteous maker :   Sâni'-i Zuljamâl,  Sâni'-i Zuljalâl , Sâni'-i Zuljamâl,  Fâtir-i Zuljalâl, Sani'-i Zuljamâl
all-beauteous one of glory :   Zat-i Jamîl-i Züljalâl, Jamîl-i Zuljalâl, Jalîl-i Zuljamâl
all-beings :   mawjûdât,  kâinât
all-compassionate :   Rahîm,  Rahîm
all-compassionate all-beauteous one :   Rahîm-i Zulcamâl
all-compassionate and beauteous one :   Rahîm-i Zuljamâl
all-compassionate and generous creator :   Khâliq-i Rahîm and Karîm
all-compassionate and generous one :   Zat­i Rahîm­i Karîm
all-compassionate beauteous disposer :   Mudabbir-i Rahîm-i Zuljamâl
all-compassionate bestower of bounties :   Mun'im-i Rahîm
all-compassionate creator :   Khâliq-i Rahîm
all-compassionate maker :   Sâni'-i Rahîm
all-compassionate one :   Qadîr-i Rahîm,  Rahmânu'r-Rahîm
all-compassionate one of beauty :   Rahîm-i Zuljamâl
all-compassionate one of glory :   Rahîm-i Zât-i Zuljalâl
all-compassionate one of riches :   Ghaniyy-i Rahîm
all-compassionate owner :   Mâlik-i Rahîm
all-compassionate protector :   Hafîz-i Rahîm
all-compassionate provider :   Razzâq-i Rahîm
all-compassionate sustainer :   Rabb-i Rahîm,  Rabb-i Rahîm
all-compelling :   Jabbâr
all-compelling and glorious one :   Qahhâr-i Zuljalâl
all-compelling! :   Yâ Jalîl, Yâ Jalîl, Yâ 'Azîz, Yâ Jabbâr
all-embracing :   shâmil
all-generous :   Karîm,  Karîm,  Karîm
all-generous all-rich one :   Ghaniyy-i Karîm
all-generous and beauteous creator :   Fâtir-i Karîm-i Zuljamâl
all-generous and compassionate one :   Karîm-i Rahîm
all-generous and munificent one :   Jawwâd-i Karîm
all-generous bestower :   Mun'im-i Karim
all-generous creator :   Khâliq-i Karîm,  Khâliq-i Karîm
all-generous lord :   Mâlik-i Karîm
all-generous one of beauty :   Karîm-i Zuljamâl
all-generous provider :   Razzâq-i Karîm
all-generous providers :   Almighty Razzâq-i Karîm
all-generous sustainer :   Rabb-i Karîm
all-glorious :   Jalîl, Zat-i Zuljamâl, Zuljalâl
all-glorious agent :   Fâ'il-i Zuljalâl
all-glorious and beauteous and munificent lord of all dominion :   Mâliku'l-Mulki Zuljalâli wa'l-jamâli wa'l-ikrâm
all-glorious and beauteous one :   Zat-i Jalîl-i Zuljamâl, Jamîl-i Zuljalâl
all-glorious and compassionate one :   Rahîm-i Zuljamâl
all-glorious and compelling subduer :   Qahhâr-i Zuljalâl
all-glorious and merciful one :   Rahmân-i Zuljamâl
all-glorious and powerful one :   Qadîr-i Zuljalâl
all-glorious creator :   Khâliq-i Zuljalâl, Fâtir-i Zuljalâl,  Fâtir-i Zuljalâl, Khâliq-i Zuljalâl,  Fâtir-i Zuljalâl, Sani'-i Zuljamâl
all-glorious creator's :   Khâliq-i Zuljalâl
all-glorious inscriber :   Naqqâsh-i Zuljalâl
all-glorious lord of the heavens :   Mâlik-i Zuljalâl
all-glorious maker :   Sâni'-i Zuljalâl,   Sâni'-i Zuljalâl , Sâni’-i Zuljalâl , Sâni'-i Zuljalâl,  Sâni'-i Zuljalâl,   Sâni’-i Zuljalâl
all-glorious monarch :   Sultân-i Zuljalâl
all-glorious one :   Zat-i Zuljalâl,   Zat-i Zuljalâl, Sâni'-i Zuljalâl,  Zat-i Zuljalâl,  Qadîr-i Zuljalâl,   Zat-i Zuljalâl
all-glorious one & sovereign of pre-eternity and post-eternity :   Zat-i Zuljalâl & Sultân-i azal and abad
all-glorious one of beauty :   Zat-i Jalîl-i Zuljamâl, Jamîl-i Zuljalâl,  Jalîl-i Zuljamâl
all-glorious one of perfection :   Jalîl, Zat-i Zuljalâl-i wa'l-kamâl
all-glorious one signified :   Musammâ-yi Zuljalâl
all-glorious one' :   Zat-i Zuljalâl
all-glorious owner :   Mâlik-i Zuljalâl
all-glorious sovereign :   Sultân-i Zuljalâl
all-glorious subduer :   Qahhâr-i Zuljalâl
all-glorious true object of worship :   Ma'bûd-u Zuljalâl
all-hearing :   Sami’,  Sami’
all-holy maker :   Sâni'-i Muqaddas
all-just :    ' dil,  'Adl,   ' dil,  'Adl
all-just and compassionate one :    ' dil-i Rahîm
all-just and wise one :    ' dil-i Hakîm
all-just arbiter :    'Adl-i Hakam
all-knowing :   ‘Alîm,  ‘alîm,   'Alîm,   'Alîm
all-knowing commander :   Âmir­i 'Alîm
all-knowing creator :   Fâtir­i 'Alîm
all-knowing inscriber :   Naqqâsh-i 'Alîm
all-knowing maker :   Sâni'-i 'Alîm
all-knowing preserver :   Hafîz­i 'Alîm
all-living and self-sufficient one :   Hayy-i Qayyûm
all-merciful :   Rahmân, Rahîm,  Rahmân,  Rahmânu'r-Rahîm
all-merciful and all-compassionate one :   Rahmân-i Rahîm
all-merciful and compassionate :   Rahmânu'r-Rahîm,  Rahmânu'r-Rahîm
all-merciful and compassionate one :   Zat­i Rahmânu'r­Rahîm , Rahmân-i Rahîm,  Rahmân-i Rahîm
all-merciful one :   Rahmân, Rahmâniyyah
all-merciful one of perfection :   Rahmân-i Zulkamâl
all-merciful one's :   Rahmânî
all-merciful' :   Rahmân
all-perfect beloved one :   Mahbûb-u Zulkamâl
all-perfect maker :   Sâni'-i Zulkamâl
all-perfect ruler :   Hâkim-i Zulkamâl
all-power and glorious one :   Qadîr-i Zuljalâl
all-power one of glory :   Qadîr-i Zuljalâl
all-powerful :   Qadîr,  Qadîr,  Qadîr,  Qadîr,  Qadîr-i Zuljalâl
all-powerful - creator :   Qadîr - Khâliq (ayrı ayrı)
all-powerful - giver of life :   Qadîr - Muhyî (ayrı ayrı)
all-powerful and all-compassionate one :   Qadîr-i Rahîm
all-powerful and all-knowing :   Qādir-i 'Alîm
all-powerful and all-knowing one :   Qadîr-i 'Alîm, Zat-i Qadîr-i 'Alîm
all-powerful and generous one :   Qadîr-i Karîm
all-powerful and glorious one :   Qadîr-i Zuljalâl
all-powerful and self-subsistent one :   Qadîr-i Qayyum
all-powerful and wise one :   Qadîr-i Hakîm,  Qadîr-i Hakîm
all-powerful maker :   Sâni'-i Qadîr
all-powerful one :   Qadîr
all-powerful one of glory :   Qadîr-i Zuljalâl,   Qadîr-i Zuljalâl,  Qadîr-i Zuljalâl,   Qadîr-i Zuljalâl,  Qadîr-i Zuljalâl,  Qadîr-i Zuljalâl
all-powerful one of perfection :   Qadîr-i Zulkamâl,  Qadîr-i Zulkamâl
all-praise and thanks be to god :   Alhamdulillâh
all-praise be to god :   Alhamdulillâh,  alhamdulillâh
all-praise be to god for the light of belief :   Alhamdulillâhi 'alâ nûri'l-îmân
all-present and all-seeing :   Hakîm-i Mutlaq
all-seeing :   Basîr,  Basîr,  Basîr
all-seeing maker :   Sâni'-i Basîr
all-wise :   Hakîm,   Hakîm,  Hakîm, Karîm, Hakam,  Hakîm,  Hakîm
all-wise & maker :   Sâni'-i Hakîm
all-wise and all-powerful one :   Qadîr-i Hakîm
all-wise and beauteous one :   Hakîm-i Zuljamâl
all-wise and compassionate :   Hakîm-i Rahîm
all-wise and compassionate one :   Hakîm-i Rahîm
all-wise and glorious maker :   Sâni'-i Hakîm-i Zuljalâl
all-wise and glorious nurturer :   Murabbi-i Hakîm-i Zuljalâl
all-wise and glorious one :   Hakîm-i Zuljalâl,  Hakîm-i Zuljalâl
all-wise and powerful one :   Qadîr-i Hakîm
all-wise author :   Fâil-i Hakîm
all-wise creator :   Fâtir-i Hakîm, Sâni'-i Hakîm , Khâliq-i Hakîm,  Fâtir-i Hakîm, Khâliq-i Hakîm, Sâni'-i Hakîm
all-wise disposer :   Mudabbir-i Hakîm
all-wise maker :   Sâni'-i Hakîm,   Sâni’ Hakîm,  Sâni’-i Hakîm , Sâni'-i Hakîm , Fâtir-i Hakîm,  Sâni’-i Hakîm , Sâni'-i Hakîm, Sâni'-i Hakîm
all-wise mover :   Sâiq-i Hakîm
all-wise one :   Hakîm
all-wise one of beauty :   Hakîm-i Zuljamâl
all-wise one of glory :   Hakîm-i Zuljalâl, Zat-i Hakîm-i Zuljalâl,  Hakîm-i Zuljalâl
all-wise one of perfection :   Hakîm-i Zulkamâl,  Hakîm-i Zulkamâl
all-wise planner :   Hakîm-i Mudabbîr
all-wise possessor of glory :   Hakîm-i Zuljalâl
all-wise preserver :   Hafîz­i Hakîm
all-wise provider :   Razzâq-i Hakîm
all-wise qur'an :   Qur’an-i Hakîm, Hakîm, Qur'an-i Hakîm,  Qur’an-i Hakîm
all-wise qur'an of miraculous exposition :   Hakîm-i Mu'jiz-ul Bayân
all-wise ruler :   Hâkim-i Hakîm
all-wise sovereign :   Hâkim­i Hakîm
all-wise sustainer :   Rabb­i Hakîm,  Rabb­i Hakîm
allah :   Hudâ, Allah
allah almighty :   Janâb Haqq
allah forbid :   Hâshâ wa kallâ, hâshâ
allah is most great! :   Allahu Akbar
allah willing :   inshâAllah
allah's leave :   idznillah
allah's most noble messenger (peace and blessings be upon him) :   Rasûl-u Akram alayhissalâtu wassalâm,  Rasûl-i Akram alayhissalâtu wassalâm
allah's noble messenger (pbuh) :   Rasûl-i Akram alayhissalâtu wassalâm
allah's noble messenger (peace and blessings be upon him) :   Rasûl-i Akram alayhissalâtu wassalâm
almighty allah :   Hakîm-i Mutlaq
almighty god :   Janâb Haqq,  Almighty Allah, Almighty Khâliq, Haqq, Allah,  Almighty Allah, Allah,  Janâb Haqq
alms :   sadaqah
alms-giving :   sadaqah
almsgiving :   sadaqah,  sadaqah
amen :   âmin,  âmin,  âmin,   min Allahumma âmin,  âmin
amusement :   lahwiyyâh
an eternal beloved :   mahbûb
an eternal monarch :   Sultân-i Sarmadî
an obligation :   fardh
an undying beloved :   Mahbûb
and again :   hâshâ summa hâshâ
and syria :   Basra, Kûfa, Shâm
and that's the matter in a nutshell :   wassalâm
angel azra'il (peace be upon him) :   Azrâîl alayhissalâm
angels :   malâikah
animal :   haywanât,  nafsânî
animate :   dzî hayât
animate beings :   dzî hayât
another :   riwâyah
answerer of prayer :   Mujîb
apparent :   dzahirî
apparent meaning of things :   ma'nâ-i ismî
appearance :   sûrat
appointed hour :   ajal,  ajal
arabian :   'Arabî
arabian peninsula :   Jazîrat-ul 'Arab
arabic :   'Arabî
arabic grammar :   Sarf and Nahw
arapça yazılı zaten! :   kun fayakûn
archangel michael :   Mîkâîl
archangel michael (peace be upon him) :   Mîkâîl alayhissalâm
arranger :   Murattib
art :   san’at
artistry :   san’at
ascended to a "distance of two bow-lengths." :   Sâhib-i Mi'râc
ascension :   mi’râj,  mi’râj, mi'râjiyyah, mi'râj, Mi'râj, Mİ’R J, mi’râj-i karâmah,  mi'râj,  mi'râj
ascension in divine knowledge :   mi'râj-i mârifah
ascension of muhammad (pbuh) :   mi'râj-i Ahmadiyyah (asm)
ascent :   mi'râj
ash'ari :   Ash'arî
aspects :   sha’n
association of ideas :   tadâ’î afkâr
atom :   dzarrah
atonement for sins :   kaffâratu'z-zunûb
attributes :   awsâf
auspiciousness of belief :   îmân
author :   kâtib, fâil
authorities :   muhaqqiq
avenger :   Muntaqîm
ayat al-kursi :   âyat'ul Kursî,   yat'ul Kursî,  yatu'l-Kursî
aynısı :   Imâm-i Shâfi'î, hadîth-i sharîf
azra'il :    'Azrâîl,  Azrâîl
azra'il  pbh :    'Azrâîl alayhissalâm
azân :   azân
balance :    mîzân,  wazn,  mîzân
barakallah :   bârakallah, Bârakallah
bashârât :   bashârât
basra :   Basra, Kûfa, Shâm
bayazid bistami :   Bayazid-i Bistamî
be and it is :   kun fayakûn
be! :   kun fayakûn, kâf-nûn, Kun
bear witness :   shahâdah
bearing the meaning of another :   ma'nâ-i harfî
beauteous all-merciful one :   Rahmân-i Zuljamâl
beauteous creator :   Fâtir-i Zuljalâl
beauteous maker :   Fâtir-i Zuljamâl, Sâni'-i Zuljamâl,  Sâni’-i Zuljamâl
beauteous one of glory :   Ma'bûd-u Jamîl-i Zuljalâl, Jamîl-i Zuljalâl,  Jamîl-i Zuljalâl
beauteous one of perfection :   Jamîl-i Zulkamâl
beautiful :   Jamîl
beauty :   jamâl,  Jamâl
being :   Dzât,  Dzât (ASM)
being possessing absolute knowledge :    'Alîm-i Mutlaq
being unlettered :   being ummî
beings :   nafs, mawjûdât
beings which looks to its creator :   malakûtiyyah
belief :   îmân, i’tiqâd,  ÎM N,  îmân , Îmân, Îmânî,  îmân , Îmân, Îmâniyyah, îmâniyyah, îmânî, îmân, îmân-i billâh, mazhabs, Îmânî,  'aqâid,  îmân , Îmân, îmân,  i'tiqâd
belief in allah :   îmân billah
belief in god :   îmân-i billâh,  îmân , âmantu billâh, îmân-i billâh,  îmân-i billâh
believe :   îmân
believed :   îmân
believer :   mu'min, mu'mins, mu’min,  mu'min
believers :   mu'min, people of îmân, îmân , mu'mins, ahl-i tawhîd,  ahl-i îmân
believers' :   mu'mins'
believing :   mu'min,  mu'min
believing man :   mu'min
believing servant :    'abd-i mu'min
beloved :   Habîb, Mahbûb,  mahbûb,  mahbûb
beloved of god :   Habîbullah
beloved one :   Habîb
beloveds :   mahbûb
benediction :   salawât-i sharîfah
benedictions :   salawât
beneficent :   Muhsin
benevolence :   lutûf
beseeching :   make(s) du'a
best of forms :   ahsan taqwîm
bestower :   Mun'im,  Mun'im,  mun'im
bestower of beauty :   Mujammil
bestower of bounties :   Mun'im, Muhsin
bestower of bounties and giver of life :   Almighty Mun'im-i Muhyî
bestower of favours :   Mufadhdhil
bestower of life :   Wâhibu'l-Hayât
bestower' :   Almighty Mun'im
bible :   Injîl
bilmillah :   Bismillah
birth :   walâdah
bismillah :   Bismillah
bitter food :   zaqqûms
blessed :   mubârak, Mubârak,  mubârak, Mubârak
blessed age :   'Asr Sa’âdah
blessed age of the prophet :   'Asr Sa’âdah
blessed be god :   bârakallah
blesseed salutations and benediction :   tahiyyat-i mubârakahs, salawât-i tayyibah
blessing :   ihsân,  ni’mah,  faydh
blessings :   ihsânât,  karâmah,  fuyuzât
bliss :   Sa’âdah
bondsman :   'abd
book :   kitâb
born of unanimity :   tawâtur
bounties :   ni’mats,  in’âm,  ihsânât
bountiful :   Mun'im,  Muhsin
bounty :   ihsân,  ni’mah,  barakah
bravo's :   bârakallah
bridge :   sirât
bringer of sure news :   Mukhbir-i Sâdiq
bringer of sure news (pbuh) :   Mukhbir-i Sâdiq (asm),  Mukhbir-i Sâdiq
buraq :   burâq, Burâq,  Burâq, burâq
by no means :   Kallâ
calamity :   musîbat
call :   azân
canon law :   usûlu'l-fiqh,  fiqh
caprice :   hawâ'
carrion :   jîfah
causer of causes :   Musabbibu'l­asbâb
celebrated :   mashhûr
certain :   tahqîqî
certain knowledge :   ‘ilm’al-yaqîn
certainty :   yaqîn
certainty at the degree of knowledge :    'ilmalyaqîn
changes :   tahawwulât
chapters :   surah
character :   shakhs-i ma'nawî,  sîrat
chief-reciter :   chief-zâkir
children of israel :   Banî Isrâîl
chipper-like muqatt'at :   muqatta'ât hurûf
choice :   ikhtiyâr
christian :   Nasârah
christians :   Ahl-i Taslîs
claim to mastery :   rubûbiyyah
clear book :   Kitâb-i Mubîn
clear book or record :   Kitâb-i Mubîn
clear certainty :    'aynalyaqîn
clear record :   Imâm-i Mubîn
clement and benevolent :   Hannân­i Mannân
closeness to god :   qurbiyyah
code of laws :   sharî'ah
collective personality :   shakhsiyat-i ma'nawiyyah, shakhs-i ma'nawî
command :   amr
commander-in-chief :   shakhs-i ma'nawî
commentaries :   tafsîr,  tafsîr
commentary :   tafsîr-i sharîf, tafsîr,  tafsîr
commentator :   mufassir
commentators :   mufassirs
commodity :   matâ'
communities :   ummahs,  ummahs
community :   ummah, jamâ'ah,  jamâ'ah, ummah
community of muhammad (pbuh) :   ummat-i Muhammadiyyah (asm)
companion :   sahâbah
companions :   sahâbahs, sahâbah,  sahâbah, sahâbahs
companions of the prophet :   sahâbah, sahâbahs,  sahâbahs,  sahâbah,  Ashâb
companions of the prophet (pbuh) :   sahâbah
companions of the prophet (peace and blessings be upon him) :   sahâbah
comparison :   tamthîl
compassion :   marhamat
compassionate :   Rahmân,  Rahmân,  Rahîm,  Ar-Rahîm, Rahîm,   Bismillah,  Bismillahirrahmânirrahîm,  Bismillahirrahmânirrahîm
compassionate - knowing :   Rahîm - 'Alîm
compassionate all-wise one :   Rahîm-i Hakîm
compassionate and merciful being :   Dzât Rahmân Rahîm
compassionate creator :   Fâtir-i Rahîm, Khâliq-i Rahîm, Khallâq-i Rahîm,  Khâliq-i Rahîm
compassionate one :   Rahmâniyyah
compassionate sustainer :   Rabb-i Rahîm, Rahîm & Rabb (ayrı ayrı)
complete certainty :    'aynalyaqîn
comprehensive :   muhît,  kullî
concourse :   ijtimâ'
concurrence :   ijmâ'
condemnation :   tadyîf
confession of faith :   KALİMATU'SH-SHAH DAH, Kalimatu'sh-shahâdah
confirmation :   tasdîq
confirmation by consensus :   tawâtur
confrontation :   tasâdum
congregation :   jamâ'ah
conscience :   wijdân
conscious :   dzî shu’ûr,  shu’ûr
consciousness :   shu’ûr
consensus :   tawâtur,  tawâtur,  ijmâ'
constantly recited :   wird
contemplate :   make tafakkur
contemplation :   tafakkur,  tafakkur, tafakkurât
contemplation and reflection :   tafakkur
contentment :   qanâ'at,  ridâ’,  ridâ'
contingency :   imkân, mumkinât
contingent :   imkân, mumkinât
continuance :   sarmadî,  baqâ
controller :   Mudabbir
conversation :   munâjât,  munâjât
conveying :   tablîgh
conveyor :   muballîgh
conviction :   i'tiqâd
corpse :  jasad
correct :   haqîqat
correctly and with attention :   ta'dîl-i arkân
correspondence :   ittifâq
cosmos :   kâinât
courage :   jasârah
cow :   Al-Baqarah
createdness :   hudûs
creation :   kâinât,  khilqah, makhlûq
creative :   Fâtir,  Fâtir
creativity :   Khâliqiyyah, khallâqiyyah
creator :   Khâliq, Sânî,  Khâliq, Haqq, Fâtir,  Khâliq, khallâqiyyah, Fâtir, Khallâq, Sâni', Haqq,  khâliq,   Khâliq,  Khâliq,  Khâliq
creator of all things :   Sâni'-i Zuljalâl , Khâliq of All Things, Khâliq of all things
creator's :   Khâliq
creator's unity :   tawhîd-i Khâliq
creature :   makhlûq
creatures :   makhlûqât,  makhlûqât
creeds :   mazhabs
criterion :   Furqân, Furqânî
curse :   la'nat
dajjal :   Dajjâl
damascus :   Shâm
david :   Dâwûd
david (peace be upon him) :   Dâwûd alayhissalâm
david and solomon (peace be upon them) :   Dâwûd and Sulaymân alayhimassalâm
david's (pbh) praises and glorifications :   Dâwûd alayhissalâm's tasbîhât
dealer of death :   Mumît
death :   mawt,  ajal
decisive arguments :   bihaqqalyaqîn
declaring him to be all-holy :   tawhîd
decline :   suqût
decorated :   muzayyan,  zîynat-ful
decree :   qadha,  Farmân,  farmân
deed :   ‘amal, tasarruf,  sadaqah,  'amal
deeds :   a’mâl, af’âl, tasarrufât
defeated :   maghlûb
delight :   ladzdzat, zawq
delusions :   waswasah
denial :   inkâr
denial of schools of law :   denial of mazhabs
dervishes :   zikr
describing the eternally besought one :   Samadâniyyah
designer :   Mudabbir, Bâri
desired :   Marghûb
desired one :   matlûb
destiny :   qadar
determiner :   Muqaddir
determiner of light :   Muqaddiru'n-Nur
determining :   Qadar, qadar,  qadar
devil :   Shaytân
devout :   muttaqî
difference :   ikhtilâf
different :   mukhtalif
difficult :   mushkil
difficulties :   mushkilât
difficulty :   mushkil
dihya :   Dihya
direct vision :   shuhûd
director :   Mudabbir
disaster :   musîbat
disbelief :   kufr
discernment distinguishing truth and falsehood :   Furqân
discretion :   sinn taklîf
disjointed letters :   muqatta'ât,  muqatta'ât-i hurûf
dispenser of needs :   Qâ'diyu'l-Hâjât
disposer :   Mudabbir,  Mudabbir, Mutasarrif,  Qadîr, 'Alîm, Hakîm, Mudabbir
dissembler :   munâfiq
dissension :   fitnah
dissipation :   safâhat
distance of two bow-lengths :   Qâb-i Qawsayn,   Qâb-i Qawsayn
distance of two bow-strings :   Qâb-i Qawsayn,   Qâb-i Qawsayn
distinguisher between truth and falsehood :   Furqân
divine :   ilâhî,  Ilâhî,  Subhâniyyah, Subhanî, Allah, ulûhiyyah, Haqq, azalî, Ilâh,  Subhânî, Rabbâniyyah, Rabbânî,  Subhânî, Yazdân,  ilâhiyyah
divine attributes :   Sifât Ilâhiyyah
divine compassion :   rahîmiyyah, marhamat Ilâhiyyah
divine court :   ulûhiyyah
divine decree :   qadha,  Qadha
divine determining :   qadar,  Qadar, qadar, muqaddarât,  qadar
divine determining and decree :   qadha and qadar
divine dominicality :   rubûbiyyah
divine eternal besoughtedness :   Samadâniyyah
divine ethics :   akhlâq Ilâhiyyah
divine existence :   wujûd,  wujûd
divine immediacy :   aqrabiyyah
divine justice :    'adâlat Ilâhîyyah,   'Adâlatullah
divine knowledge :   ‘ilm ilâhî,  ma'rifah
divine laws :    'âdatullah,   'âdatullah
divine mercy :   rahmat Ilâhiyyah
divine name of light :   Nûr
divine names :   Asmâ İlâhiyyah,  Asmâ Ilâhiyyah
divine oneness :   ahadiyyah,  ahadiyyah,  ahadiyyah,  'arsh-i ahadiyyah, Zat-i Ahadiyyah,  ahadiyyah
divine oneness and eternal besoughtedness :   ahadiyyah and Samadiyyah
divine power :   qudrat Ilâhîyyah
divine presence :   hudûr ilahî
divine proximity :   qurbiyyah
divine sovereignty :   Saltanât Ulûhiyyâh
divine speech :   kalâm,  kalâmullâh
divine support :   tawfîq, tawfîq ilâhî
divine throne :   ‘arsh ‘azhâm,   ‘arsh,   ‘arsh
divine unity :   wâhidiyyah, tawhîd, wahdâniyyah,  wahdah & wâhidiyyah, wâhidiyyah, wahdah, tawhîd,  wahdâniyyah, wâhidiyyah, tawhîd, wahdah, TAWHÎD,  Wahdâniyyah, tawhîd, wahdâniyyah, wahdah,  wahdâniyyah, tawhîd
divine wisdom :   hikmat Ilâhîyyah
divine word :   kalâmullâh
divinity :   Ulûhiyyâh,  ulûhiyyah,  ulûhiyyah,  ulûhiyyah
dominical :   Rabbânî,  Rubûbiyyah,  Rabbâniyyah,  Rabbâniyyah, Rahmânî, Rabbânî, rubûbiyyah,  Rabbâniyyah, Rabbânî, rubûbiyyah
dominical glorification :   tasbihât-i Rabbâniyyah
dominical glorifications :   tasbihât-i Rabbâniyyah
dominical leave :   idzn Rabbânî
dominical praise :   tahmîdât-i Rabbâniyyah
dominical revelation :   wahy-i Rabbânî
dominical riches. :   Rabbâniyyah
dominical speech :   kalâm Rabbânî
dominical the perfection :   rubûbiyyah
dominicality :   Rubûbiyyah,  Rubûbiyyah,  rubûbiyyah,  rubûbiyyah, Rabbâniyyah, rubûbiyyahs, Rubûbiyyah,  rubûbiyyah
dominion in both its outer face and its face which looks to him :   mulk and malakût
doomsday :   qiyâmah
doubt :   waswasah,  waswasah
doubts :   waswasah,  waswasah
drawing :   azalî
dtermining :   qadar
duties :   farâidh
dzawi’l-arwâh :   dzawi’l-arwâh
dzawi’l-hayâh :   dzawi’l-hayâh
dzât dzul jalâl :   Dzât Dzul Jalâl
dzât wâjib-ul wujûd :   Dzât Wâjib-ul Wujûd
dzâtî and ‘âridî :   dzâtî and ‘âridî
early morning :   fajr
earth :   ard,   ‘arsh
effulgence :   faydh, Faydh,  faydh, barakah
effulgence of belief :   faydh-i îmân
ego :   anâniyyah,  anâniyyah,  ana
egos :   Anâniyyah
egotism :   anâniyyah, ana,  anâniyyah
eight signs :   Rumuzât-i Samâniyah
eklendi :   Wâjibu'l-wujûd , Wâhid-i Ahad
elevated and authoritative :   muhaqqiqîn
emanations :   faydhs
embroider :   Naqqâsh
encompassing :   muhît
end of the world :   qiyâmah
enduring eternal one :   Dâim-i Haqîqî
enduring everlasting one :   Bâki-i Lâyazâl, Bâki-i Sarmadî
enduring object of worship :   Ma'bûd-u Lâyazal
enemy :   khasm
enjoy :   ladzdzat, zawq
enjoyment :   ladzdzat, zawq
enmity :   'adâwat
envier :   hâsid
envious :   hâsid
envoy :   mab'ûth,  ma'mûr
envy :   hasad
equilibrium :   muwâzanah, mîzân
era of bliss :   'Asr Sa’âdah
era of bliss or age of the prophet (pbuh) :   Fakhr-i 'âlam (asm)
essence :   mâhiyyah, khulâsah
eternal :   sarmadî,  abadî,  Azalî,  Bâqî,  Samadâniyyah, Bâqî,  sarmadî, sarmadiyyah
eternal all-beauteous one :   Jamîl-i Bâqî
eternal all-powerful one :   Qadîr-i Lâyazâl
eternal all-wise one. :   Hakîm-i Lâyazâl
eternal and self-subsistent lord of glory :   Qayyûm-u Bâqî, Zat-i Zuljalâl
eternal annihilation :   i’dâm abadî
eternal beauteous one :   sarmadî
eternal beautya :   Jamâl-i Bâqî
eternal being :   Mawjûd-u Lamyazal
eternal beloved :   Ma'bûd, Mahbûb-u Sarmadî, Mahbûb-u Bâqî
eternal beloved one :   Mahbûb-u Lâyazal
eternal besoughtedness :   Samadâniyyah, Samadiyyah,  Samadâniyyah, Samadiyyah
eternal bliss :   sa’âdat abadiyyah
eternal happiness :   sa’âdat abadiyyah
eternal life :   hayât ukhrawiyyah,  hayât bâqiyyah, hayât sarmadiyyah, hayât azaliyyah
eternal maker :    Sâni’ Sarmadî
eternal realm :   ‘âlam bâqî
eternal sovereign :   Sultân-i Sarmadî
eternal sun :   Shams-i Sarmadî,   Shams-i Sarmad
eternal undying one :   Qadîm-i Lamyazal
eternal void :   i’dâm abadî
eternal worshipped one :   Ma'bûd-u Lamyazal
eternally besought :   Samad
eternally besought one :   Samadâniyyah,  Samadâniyyah, Samad, Samadiyyah,  Samadâniyyah, Samad, Samadiyyah,  Zat-i Ahad-i Samad
eternally besought one's :   Samadâniyyah
eternally living one :   Hayy
eternally self-subsistent :   Mun'im-i Haqîqî
eternally self-subsistent one :   Qayyûm-u Sarmadî
eternity :   baqâ,  baqâ,  samadiyyah, sarmadiyyah,  sarmadiyyah
evening :   maghrib
ever-living :   Hayy,   Zat-i Hayy-i Qayyûm
ever-living and self-subsistent :   Hayy-i Qayyûm
ever-living and self-subsistent one :   Hayy-i Qayyûm, Hayy-i Bâqî,  Hayy-i Qayyûm
ever-living eternal one :   Hayy-i Bâqî, Qayyûm-u Bâqî
everlasting :   abadî,  sarmadiyyah
everlasting life :   hayât ukhrawiyyah,  hayât bâqiyyah, hayât sarmadiyyah, hayât azaliyyah
everlasting pre-eternal one :   Qadîm-i Bâkî
everlastingness :   sarmadiyyah
evil :   sharr
evil suggestions :   waswâs
evil-commanding soul :   nafs,  nafs ammârah
evil-commanding souls :   nafs,  nafs'
exact scholars :   muhaqqiq
exacting scholars :   muhaqqiq,  muhaqqiq
exaltation :   jalâl,  takbîr,  takbîr
exalted creator :   Khâliq-i Ta'âlâ
exalted names :   Ism A‘zham
excellence :   fadîlah
exempt :   munazzah,  munazzah
existence :   wujûd,  wahdah, wujûd , wujûd,  wujûb-u wujûd, wujûd, wujûd,  wujûd
explanations :   tafsîrs
exquisiteness :   latâif
external :   mulk
external face of the world of existence :   mulk
extolling :   ta’zîm, tahiyyahs,  takbîr
extravagance :   isrâf
extreme cold :   zamharîr
face that looks to its creator :   malakût
fact :   haqîqat
faculties :   latâif,  latîfah, latîfahs
faculty of will :   juz’ ikhtiyârî
fair ending :   husn khâtimah
faith :   îmân, i’tiqâd,  îmân ,  'aqîdah,  îmân , îmân, Îmân,  i'tiqâd
faithfully :   sadâqah
familiarity :   ulfah
fancying :   tawahhum
farthest lote-tree :   Sidratu'lmuntahâ
farthest mosque :   Masjid-i Aqsâ,  Masjid-i Aqsâ
fashioner :   Naqqâsh,  sâni'
fatiha :   Fâtihah,  Fâtihah
fatima :   Fâtima
favour :   ihsân
fear of allah :   khawfullah
fear of god :   taqwâ, makhâfatullah, taqwa,  taqwâ
felicitous :   su'adâ
felicity :   Sa’âdah
fellow feeling :   sila-i rahîm
festival ('eid) :    'iyd
fiil :   Fiil, tafakkur, hamd, tasbîh, taqdîs, tawhîd, tasbihât, zikr,  Fiil, fiil
finest of forms :   ahsan-i taqwîm
fire-worshippers :   Mejûsîs
firmest of judges :   Ahkamu'l-Hâkimîn
firmness :   thabât
first generations :   salaf, salaf-i sâlihîn
fish :   hût,   Hût
five hidden things :   mughayyabât-i khamsah
fi̇i̇l :   îmân
food :   ta‘âm,  arzâq
footnote :   hâshiyah
for god's sake :   for Allah's sake
for god’s sake :   liwajhillâh
for the sake of allah :   liwajhillâh
for themselves :   ma'nâ-i ismî
forbidden :   harâm,  harâm
foregiveness :   istighfâr
foremost :   imâm
forgiveness :   istighfâr, maghfirah
form :   sûrah
fortunate :   mubârak
free :   munazzah
free of and beyond :   munazzah from
friday prayers :   jumu'ah
friday sermon :   khutbah,  khutbah
frugality :   iqtisâd
fruit :  thamarah
fruitless :   ‘abath
function :   wazhîfah
furthest lote-tree :   Sidratu’lmuntahâ
futility :   ‘abathiyyah
future belongs to the god-conscious :    qibatu'l-muttaqîn
gabriel :   Jabrâîl,  Jabrâîl
garden of abode :   jannat’ul-ma’wâ
gather :   ijtimâ'
generation succeeding the prophet :   tâbi'în
generous :   Karîm,  Karîm
generous creator :   Fâtir-i Karîm
generous host :   Mihmândâr-i Karîm,  Mihmândâr-i Karîm
generous one :   Zat-i Karîm
generous provider :   Razzâq-i Karîm
generous sustainer :   Razzâq-i Karîm
gentle :   Hannân
gentleness :   tahannûn,  tahannun, tahannûn
ghaniyy ‘ala-l itlâq :   Ghaniyy ‘Ala-l Itlâq
gift :   ihsân
giver of existence :   Mûjid
giver of form :   Musawwir
giver of life :   Muhyî,  Muhyî
giver of life and death :   Muhyî and Mumît
glorification :   tasbihât, tasbîh, tasbîhiyah,  tasbîh, tasbihât, tasbîhiyah, zikr, tasbîhs
glorification of god :   zikr, tasbihât
glorifications :   tasbihât, tasbîh, Tasbihât, tasbîhs,  tasbihât
glorified :   Tasbihât
glorifiers :   musabbihs
glorify :   tasbihât,  tasbîh
glorifying :   tasbîh
glorious and munificent lord of all dominion :   Mâliku'l-Mulki Zuljalâli wa'l-ikrâm
glorious and perfect one :   Zat-i Zuljamâl-i wa'l-kamâl
glorious being :   Zat-i Zuljalâl
glorious creator :   Fâtir-i Zuljalâl, Khâliq-i Zuljalâl,  Khâliq-i Zuljalâl, Fâtir-i Zuljalâl
glorious criterion of truth and falsehood :   Furqân-i Jalîlushshân
glorious fashioner :   Sâni'-i Zuljalâl
glorious lord of all dominion :   Mâliku'l-mulki Zuljalâl,  Mâliku'l-Mulki Zuljalâl
glorious maker :   Sâni’ Dzu’l Jalâl,  Fâtir-i Zuljalâl, Sâni’-i Zuljalâl , Sâni'-i Zuljalâl,  Sâni'-i Zuljalâl
glorious monarch :   Sultân-i Zuljalâl
glorious one :   Zat-i Zuljalâl
glorious one of beauty :   Jalîl-i Zuljamâl
glorious sustainer :   Rabb-i Zuljalâl
glory be to god :   Subhânallah
glory be to god! all praise be to god :   Subhânallah, Walhamdulillah
glory be to god! what wonders god has willed! god is most great :   Subhânallah, Mâshâallah, Allahu Akbar
glory of messengership :   Fakhr-i Risâlah
glory of the messengers :   Fakhr-i Rusul
glory of the world :   Fakhr ' lam
glory to be god :   Subhânallah
gnostic :   ahl ma'rifah
god :   Allah,  Allah, Ilâh, Almighty Allah, Rabb, Haqq, Hudâ, ALLAH,  Allah,  Janâb Haqq
god (may his glory be exalted) :   Almighty Allah (c.c)
god almighty :   Janâb Haqq,  Almighty Allah, Allah,  Almighty Allah
god forbid :   Hâshâ,  Hâshâ, Hâshâ wa kallâ, hâshâ, hâshâ summa hâshâ, Kallâ, hâshâ wa kallâ, al-'iyâzu billâh,  hâshâ summa hâshâ,  hâshâ summa hâshâ
god is most great :   Allahu Akbar, Allahu akbar,  Allahu Akbar,  Allahu Akbar
god is most great! :   Allahu Akbar
god willing :   inshâallah
god's beloved :   Habîbullah
god's beloved (pbuh) :   Habîbullah (asm)
god's book :   Kitâbullah
god's conscious servants :   Allah (slaves of Allah)
god's dominicality :   rubûbiyyah
god's messenger :   Rasûlullah,  Rasûlullah
god's messenger (pbuh) :   Rasûl-i Akram
god's most noble beloved :   Habîb-i Akram
god's most noble messenger :   Rasûl-u Akram
god's noble messenger :   Rasûl-i Akram, Rasûl-u Akram
god's noble messenger (pbuh) :   Rasûl-i Akram (asm), Rasûl-i Akram
god's noble messenger (peace and blessings be upon him) :   Rasûl-i Akram alayhissalâtu wassalâm
god's sake :   liwajhillâh, lillâh,  lillâh
god's servants :   Allah's servants
god's slaves :   Allah (slaves of Allah)
god's throne :    'arsh-i a'zam
god's unity :   tawhîd
god's wise one :   Hakîm-i Ilâhî (Burda dikkatli ol)
god's word :   kalâmullâh
godhead :   ulûhiyyah,,  ulûhiyyah,  ulûhiyyah, rubûbiyyah
god’s most noble messenger :   Rasûl Akram
god’s permission :   idznillah
gog and magog :   Ya'jûj and Ma'jûj
good :   khayr,  abrâr
good deeds :    'amal-i sâlih
good works :    'amal-i sâlih, a’mâl-i saliha,   'amal-i sâlih, Sâlihât
gospels :   Injîl
grace :   ‘inâyat
grace of the most merciful :   Fadhl-i Rahmân
gracious :   Latîf
gramatically :   sarf
grammar :   sarf
granter of favours :   Latîf
gratitude :   shukr
grave :   qabr
great :   azhîm
greater shari'a :   greater sharî'ah, the sharî'ah of creation
greatest name :   ism-i a'zam
greed :   khirs
green birds :   Tuyûrun Khudrun
guest :   misâfir
guidance :   irshâd
hadith :   hadîth, ahadîs , HADÎTH,  hadîth-i sharîf, hadîth
hadith qudsi :   hadîth-i qudsî
hadiths :   ahâdîth-i sharîfah, hadîths, ahadîs-i sharîfah , hadîths,  ahâdîs-i sharîfah, hadîth, hadîths, ahâdîth-i sharîfah , Ahadîs, hadîths
hafiz :   hâfiz
hafizes :   hâfizes
hafîzhiyyah :   Hafîzhiyyah
hajj :   hajj, Hajj
hajji :   hajji
hamza :   hamzah
hanafi :   Hanafî
hanafi school :   mazhab-i Hanafî,  mazhab-i Hanafî
hanafis :   Hanafîs
hardship :   mushkil
has absolute power :   Qâdir-i Mutlaq
have mastery :   rubûbiyyah,  rubûbiyyah, Rabb
healer :   Shâfî,  Shâfî
hearing :   Samî’, Samî'
heart :   qalb
heaven :   samâ,  samâwât,  samâwî
heavenly :   samâwî
heavenly books :   kutûb samâwiyyah
heavenly scriptures :   suhûf samâwiyyah
heavens :   samâwât,   ‘arsh
heedless :   ghâfil
heedlessness :   ghaflah
hell :   Jahannam
hellfire :   Jahannam
here we are :   Labbayk
hereafter :   âkhirah,  âkhirah
heretics :   Râfizîs
hidden :   ghaybî,  ghaybî
hidden treasures :   kunûz makhfîyyah
highest of the high :   ‘âlâ illiyyîn
his being beyond space and yet present everywhere :   munazzah
his perfections :   Zat-i Zulkamâl
his sainthood :   walâyat-i Ahmadiyyah (asm)
his unity :   tawhîd
holy :   Karîm,  Karîm
home of paradise :   jannat’ul-ma’wâ
hostility :   'adâwah,  'adâwat
houri :   hûris
houris :   hûris, hûri,  hûris
how beautifully they have been made :   bârakallah
how great are allah's blessings! :   Bârakallah
how great are god's blessings :   bârakallah
hujjat al-islam :   Hujjat al-Islam
human :   insân
human accountability :   taklîf
human being :   naw’ insân, insân, naw’ bashar
human beings :   naw’ insân, insân, naw’ bashar
human race :   banî  dam,  naw’ insân, insân, naw’ bashar
humanity :   naw’ insân, insân, naw’ bashar
humankind :   naw’ insân, insân, naw’ bashar
husayn :   Husayn
husayn jisri :   Husayin-i Jisrî
hypocrite :   riyâful
hypocrites :   munâfiq
i place my trust in god :   tawakkul
i seek refuge with allah from satan the accursed :   al-'iyâzu billâh
ibn al-'abbas :   Ibn-i 'Abbâs
ibrâhîm :   Ibrahîm (as)
idris (puh) :   Idrîs (as)
ignorance :   jahl
ijtihad :   ijtihâd
ikhlas :   Ikhlâs
ikrâm :   ikrâm
illicit :   harâm,  harâm
illiterate :   ummî
illumination :   kashf
illumination through the self :   sayr-i anfusî
illuminator :   munawwir
illuminator of light :   Munawwiru'n-Nûr
illuminer :   Munawwir
illuminists :   ishrâqiyyûn
illustious sunna :   sunnah
illustrious practices of the prophet (pbuh) :   sunnat-i saniyyah, sharî'ah & sunnat-i saniyyah (ayrı ayrı)
illustrious shari'a :   sharî'at-i gharrâ
illustrious sunna :   sunnat-i saniyyah
imagination :   khayâl
imagining :   khayâlât, takhayyul, tasawwur
imaginings :   khayâlât, takhayyul, tasawwur
imam 'ali (may  allah be pleased with him) :   Imâm-i Ali (ra)
imam ghazzali :   Imâm­i Ghazâlî
imam rabbani :   Imâm­i Rabbanî
imam shafi'i :   Imâm­i Shâfi'î
imam-i a'zam :   Imâm­i A'zam
imam-i rabbani :   Imâm­i Rabbanî (ra), Imâm­i Rabbanî, Imâm­i Rabbanî,  Imâm-i Rabbânî, Imâm­i Rabbanî
imitation :   taqlîd
immaterial :   ma’nawî
immortal :   lâyemût
immortality :   abadiyyah, sarmadiyyah
imperishable preserver :   Zat-i Hafîz-i Bîzawâl
impotent :   daîf,  ‘âjiz,  ‘âjiz
in knowledge of god :   ma'rifatullah
in the name of god :   Bismillah,  Bismillah,  Bismillahirrahmân,  Bismillahirrahmânirrahîm,  Bismillahirrahmânirrahîm,  Bismillah,  Bismillah
in the name of god the merciful :   Bismillah
in this we believe :    mannâ, âmannâ
in veneration of the lord of the prophets :   bi-hurmati Sayyidi'l-mursalîn
independent judgements :   ijtihâd
independent judgements on points of the shari'a :   ijtihâd
independent judgements on the law :   ijtihâd
indigence :   faqr
indisputably :   bihaqqalyaqîn
individual :   nafs
ingenious :   san'atful
inheritor :   Wâris
injustice :   zhulm
inner :   malakût, malakûtiyyah, malakûtiyyah,  mulk, malakût , malakûtiyyah
inner and outer dimensions of things :   mulk, malakût
inner dimension of things :   malakût
inner dimensions :   malakûtiyyah
inner dimensions of things :   malakût,  malakût
inner face :   malakûtiyyah
inner faculties :   sirr
innovation :   bid'ah,  bid'ah
innovations :   bid'ahs
inscriber :   kâtib,  naqqâsh
inscription :   naqsh
insincere(değiştirilmedi!) :   ikhlâs
inspiration :   ilhâm
instinctual soul :   nafsâniyyah, nafs
instruction :   dars, tarbiyyah,  ta’lîm
intellect :   ‘aql
intelligence :   ‘aql
intercession :   shafâ’ah,  shafâ'ah,  shafâ'ah, shafâ'ahs
intercessor :   shafâ'ah,  shafâ'ah
intermediate :   barzah, barzahiyyah,  barzakh,  barzah
intermediate realm :   barzakh,,  barzah, barzahiyyah, barzakh, 'âlam barzakh,  barzakh
intermediate world :   barzakh,  barzakh
interpret the divine law :   ijtihâd
interpret the law :   ijtihâd
interpretation :   ijtihâd,  ijtihâdât, ijtihâd
interpretation of the law :   ijtihâd,  ijtihâdât, ijtihâd
interpretations :   ijtihâdât, ijtihâd,  ijtihâdât, ijtihâds, ijtihâd
interpreted :   yapılmadı
interpreter :   tarjumân
interpreters :   mujtahid,  mujtahids
interpreters of the law :   mujtahidîn, mujtahid,  mujtahids
interpreters of the shari'a :   mujtahids, mujtahid
interpreting the divine law :   ijtihâd
interpreting the law :   ijtihâd
investigative scholars :   muhaqqiqîn, muhaqqiq
invocation :   zikr, bid'ah,  zikr,  munâjât
inward conversation with god :   munâjât
iptal :   iptal, tasbîh, tasbihât, Yazdânî, jâiz
irhasat :   irhâsât
ishraqiyyun :   Ishrâqiyyûn
islamic community :   ummah
islamic philosophers :   Islamic hukamâ
islamic scholars :   mujtahid
ism-i azamlardan birisi yok :   ism-i azamlardan birisi yok
israfil :   Sûr-u Isrâfîl,  Isrâfîl
istinja :   istinja
it is he! it is he :   Hû Hû
it is narrated :   riwâyah
jabariyya :   Jabrî, JABR, Jabriya, Jabr
jalaluddin suyuti :   Jalâladdîn-i Suyûtî
jalîl :   Jalîl
janâb haqq :   Janâb Haqq
jawshan al-kabir :   Jawshanu'l-Kabîr
jesus :    'Îsa,   'Îsa
jesus (peace be upon him) :    'Îsa alayhissalâm
jewish :   Banî Isrâîl
jonah :   Yûnus
joseph :   Yûsuf,  Yûsuf
joseph (peace be upon him) :   Yûsuf (as), Yûsuf alayhissalâm
judge :   hâkim
judgement :   hukm
judisprudence :   usûlu’l-fiqh
jurisprudence :   usûlu’l-fiqh, usûlu'l-fiqh, usûl-u fiqh
jurisprudence (fiqh) :   usûlu'l-fiqh
just :   'âdil
just past midday :   zuhr
justice :   'adâlah
juz’î :   juz’î
ka'ba :   ka'bah
kafirun :   Qul yâ ayyuha'l-kâfirûn
karîm :   Karîm
kawthar :   kawsar,  kawsar
khidr :   Hidhir
khutba :   khutbah
khâliq dzul jalâl :   Khâliq Dzul Jalâl
khâliq rahîm :   Khâliq Rahîm
kindnesses :   lutf
king :   Sultân
king so powerful :   Malîk-i Qadîr
kingship :   hâkimiyyah
knowing :   Qadîr, 'Alîm, Hakîm, Mudabbir,   'Alîm
knowledge :   ‘ilm,  ma'rifah,  ma'rifah,  ma'rifah
knowledge of allah :   ma'rifatullah
knowledge of certainty :    'ilmalyaqîn,   'ilmalyaqîn
knowledge of god :   ma'rifatullah,  ma'rifatullah, ma'rifah,  ma'rifatullah
knowledge of the maker :   ma'rifat-i Sâni'
known :   Ma'rûf
known one :   Ma'rûf,  Ma'rûf
knows all things :    'Alîm of all things
kufa :   Basra, Kûfa, Shâm
lamp :   sirâj
large congregation :   mimbar
law :   sharî'ah
lawful :   halâl,  halâl,  halâl
laws :   sharî'ahs, sharî'ah,  sharî'ahs
laylat al-bara'a :   Laylat al-Barâah
leader :   imâm,  imâm
leader of a group reciting god's names :   sarzâkir
learned :   muhaqqiq
learned and exacting scholars :   muhaqqiqîn-i ‘ulamâ
learned and scholarly :   muhaqqiqîn
letters :   muqatta'ât
letters ya. sin. :   lafz-i Yâsîn
liberality :   karam
licence :   fatwa
licit :   halâl,  halâl
life :    hayât
life of world :   hayât dunyawiyyah
life-span :   ajal
lifeless :   jâmid
light :   nûr,  Nûr,  Nûr,  Nûr,  anwâr
light of light :   Nûru'n-Nûr
light of lights :   Nûru'l­Anwâr
light of muhammad :   Nûr-u Muhammadî
light upon light :   nûrun alâ nûr
light verses :   âyât-un Nûr
like a word :   ma'nâ-i harfî
living :   dzî hayât,  Hayy
living and self-subsistent being :   Dzât Hayy Qayyûm
living and self-subsistent one :   Hayy-i Qayyûm
living beings :   dzî hayât
lord :   rabb,  Mawlâ,  Mâlik,  Mâlik
lord of all dominion :   Mâliku'l-Mulk,  Mâliku'l-mulk
lord of all glory :   Mâlik-i Zuljalâl
lord of all sovereignty :   Mâliku'l-Mulk
lord of all things with their apparent and inner faces :   Mâliku'l-mulk wa'l-malakût
lord of glory :   Mâlik-i Zuljalâl
lord of such dominion :   Mâliku'l-Mulk
lord of the prophets :   Sayyidu’l-mursalîn
lordship :   rubûbiyyah
lote-tree :   Sidrah
lote-tree of the farthest limit :   Sidratu'lmuntahâ,  Sidratu'lmuntahâ
love :   muhabbat
love of allah :   muhabbatullah
love of god :   muhabbatullah
loving :   Wadûd
loving one :   Wadûd
lowest of the low :   asfal sâfilîn
loyal :   sâdiq
luminous :   nûrâniyyah,  munawwar
lustfully :   nafsânî
ma'shallah :   Mâshâallah
macroanthropos :   insân akbar
madîna :   Madîna
magians :   Majûsî
magic :   sihr
magnificence :   'azhâmat
mahdi :   Mahdi,  Mahdi, Sufyân
mahdi and sufyan :   Mahdi and Sufyân
mahmud :   Mahmûd
majarrat al-sama' :   Majarratu's-Samâ
majestic :   hashmatful
majestic divinity :   ulûhiyyah
majesty :   hashmat
make supplication :   make du'a
maker :   Khâliq, Sânî,  Sâni’, Fâtir, Sâni',  Sâni’, Sâni'
maker & dominicality :   Sâni’  &  rububiyyah
maker & existence :   Sâni'  &  wujûd
maker of all things :   Fâtir-i Zuljamâl
maker of glory and kindness :   Sâni'-i Zuljalâl Wal'îkrâm
maker of perfection :   Sâni'-i Zuljamâl
maker possessing perfection :   Sâni'-i Zulkamâl
maker's necessary existence and unity :   wujûb and wahdah/ Sâni'
making :   sâni'iyyah
making loved :   tawaddud,  tawaddud
making) known :   ta'arruf
maktûbât samadâniyyah :   maktûbât Samadâniyyah
man :   naw’ insân, insân, naw’ bashar
manager :   Mutasarrif
manifest :   shahâdah,  shahâdah, Shahâdah,  shahâdah,  shahâdah
manifest world :   ‘âlam shahâdah,   shahâdah
manifestation :   jilwah
manifestly :   bi'aynalyaqîn
mankind :   naw’ insân, insân, naw’ bashar
marks :   sha'âir,  sha'âir
marks and observances of islam :   sha'âir-i Islâmiyyah
masha'llah :   Mâshâallah
masnû’ât :   masnû’ât
mass of muslims :   ‘awâm-i muslimîn, Sawâd-i a'zam
master :   Mâlik,  Mâlik,  Rabb,  Mutasarrif,  ustâdz
master muhammad (peace and blessings be upon him) :   Sayyidinâ Muhammad Alayhissalâtu Wassalâm
masters of the species :   arbâb-ul anwâ'
material :   maddî
materiality :   maddiyyât
mathnawi :   masnawî
maturidi :   Mâturîdî
mawlana jami :   Mawlâna Jamî
mawlâna jamî :   Mawlâna Camî
may god be pleased with him :   radiyallahu ‘anh, radiyallâhu 'anh
may god bless this :   Bârakallah
may god bless you :   bârakallah
may god protect us :   hâshâ
may his glory be exalted :   (cc)
ma’nâ harfî :   ma’nâ harfî
ma’nâ ismî :   ma’nâ ismî
meaning that signifies something other than itself :   ma'nâ-i harfî
meaningful letter :   ma'nâ-i harfî
men :   naw’ insân, insân, naw’ bashar
mentioned :   Mazkûr
mentioning of the divine names :   zikr,  zikr-i ilâhî
merciful :   Rahîm,  Rahmân,  Rahmân, Rahîm,  Rahmâniyyah,   Bismillahirrahmân,  Bismillahirrahmânirrahîm,  Bismillahirrahmânirrahîm
merciful and compassionate one :   Rahmânu'r-Rahîm,  Zat­i Rahmânu'r­Rahîm
merciful one :   Rahmân
merciful throne :    'arsh-i Rahmânî
mercifulness :   tarahhûm
mercy :   rahmah,  Rahmân,  ghayb, marhamah,  tarahhûm
mercy to all the worlds :   Rahmatan li'l-'âlamîn,  Rahmatan li'l-'âlamîn,  Rahmatan li'l-'âlamîn, Rahmatan li'l-'âlamîn & alayhisâlâtu wassalâm (ayrı ayrı)
messenger :   nabî, rasûl, muhbîr,  rasûl
messenger (pbuh) :   Rasûl-i Akram alayhissalâtu wassalâm
messenger's (pbuh) :   Rasûl-i Akram
messengerhood :   risâlah
messengers :   anbiyâ, rusul, mursalîn, muhbîr
messengership :   nubuwwah,  risâlat
method :   awrâd,  awrâd
mevlevi :   Mawlawî,  Mawlawî
mevlevi dervishes :   Mawlawîs
midday :   zuhr
might is right :   Al-hukmu li'l-ghâlib
mighty :   kabîr
mighty embodied qur'an of the world :   Qur'an-i Akbar-i ' lam
mighty lord of all dominion :   Mâliku'l-mulk
mighty stature :    'Azîmushshân
mighty stature-i :    'Azîmushshân
mighty sustainer :   Rabb-i 'Azîm
mihrab :   mihrâb
mind :   ‘aql
miracle :   mu'jizah
miracles :   mu’jizât
miracles of muhammad :   mu’jizât Ahmadiyyah (asm)
miraculous exposition :   Mu'jizu'l-Bayân , Qur’an-i Mu'jizu'l-Bayân,  Mu'jizu'l-Bayân
miraculous exposition of :   Mu'jizu'l-Bayân
miraculousness :   i'jâz
misfortune :   musîbat
misgiving :   waswasah,  waswasah
misguidance :   dalâlah
misâfir-house :   misâfir-house
monarch :   Sultân, sultân,  sultân
monarch of pre-eternity :   Sultân-i azal,   Sultân-i azal
monarch of pre-eternity and post-eternity :   Sultân-i azal and abad, the Sultân of the azal and abad,   the Sultân of the azal and abad
moon :   qamar
moral conduct :   akhlâq
morality :   akhlâq
moses :   Mûsâ (as), Mûsâ, Mûsâ alayhissalâm
moses (pbh) :   Mûsâ alayhissalâm
moses (peace be upon him) :   alayhissalâm, Mûsâ alayhissalâm, Mûsâ (as)
moses and aaron (peace be upon them) :   Mûsâ and Hârûn alayhimassalâm, Mûsâ (as) and Hârûn (as)
moses and jesus (peace be upon them) :   Mûsâ and 'Îsâ alayhimassalâm
moses' (peace be upon him) :   Mûsâ alayhissalâm
mosque :   masjid,  masjid
mosque at mecca :   Masjid-i Harâm
mosque in jerusalem :   Masjid-i Aqsâ
mosque in mecca :   Masjid-i Harâm
mosques :   masjid,  masjids
most certainly :   bihaqqalyaqîn
most compassionate :   Rahîm
most compassionate and all-generous :   Rahîm-i Karîm
most compassionate creator :   Khâliq-i Rahîm
most compassionate of the compassionate :   Arhamu'r-Râhimîn
most compassionate one :    ' dil-i Rahîm
most compassionate sustainer :   Rabb-i Rahîm
most decisive criterion of truth and falsehood :   Furqân-i Ahkam
most excellent of patterns :   ahsan-i taqwîm,  ahsan-i taqwîm,  ahsan-i taqwîm,  ahsan-i taqwîm,   ahsan-i taqwîm,  ahsan-i taqwîm
most generous :   Karîm
most generous lord :   Sayyid-i Karîm
most generous maker :   Sâni’-i Karîm
most generous sustainer :   Rabb-i Karîm
most high sustainer :   Rabb-i 'Alâ
most holy being :   Zat-i Muqaddas
most holy divine essence :   Zat-i Muqaddasa-i Ilâhiyyah
most holy one :   Zat-i Muqaddas,   Zat-i Aqdas
most learned :   muhaqqiqîn
most merciful :   Rahmân, Rahmâniyyah, Rahmânî, Arhamu'r-Râhimîn,  Rahmân, Rahmâniyyah, Rahmânî,   Rahmâniyyah, Rahmân
most merciful and all-compassionate :   Rahmân-i Rahîm
most merciful and compassionate :   Rahmânu'r-Rahîm
most merciful and compassionate one :   Rahmân-i Rahîm, Rahmânu'r-Rahîm, Rahmânu'r-Rahîm,  Rahmânu'r-Rahîm
most merciful creator :   Fâtir-i Rahmân, Khâliq Rahmân,   Fâtir-i Rahmân, Khâliq Rahmân
most merciful of merciful :   Almighty Arhamu'ur-Râhimîn
most merciful one :   Rahmâniyyah,  Rahmân, Rahmâniyyah,  Rabbânî, Rahmân,  Rahmâniyyah,   Rahmâniyyah
most merciful one. :   Rahmân
most merciful's throne :    'arsh-i Rahmân
most munificent maker :   Sâni'-i Karîm
most munificent one :   Zat-i Karîm
most noble beloved :   Habîb-i Akram
most noble beloved one :   Habîb-i Akram
most noble messenger :   Rasûl Akram
most noble messenger (peace and blessings be upon him) :   Rasûl-u Akram alayhissalâtu wassalâm
most pure and holy deity :   Zat-i Aqdas-i Ilâhîyyah
most pure and holy divine essence :   Zat-i Aqdas-i Ilâhîyyah
most pure and holy essence :   Zat-i Aqdas,   Zat-i Aqdas
most pure and holy one :   Zat-i Aqdas,  Zat-i Aqdas
mount sinai :   Tûr-i Sînâ, Jabal-i Tûr
mu'attila :   mu'attilah
mu'mins :   îmân
mu'tazila :   I'TIZ L, i'tizâl,  Mu'tazilah
mu'tazilites :   Mu'tazilah
mu'tazilities :   i'tizâl, Mu'tazilah
muhammad :   Ahmad, Ahmadiyyah (asm), Ahmadî,  Ahmad, Zat-i Ahmadiyyah,  Muhammadiyyah (asm),  Muhammad (asm)
muhammad (pbuh) :   Ahmad (asm), Ahmad , Ahmadiyyah (asm), Muhammad (asm), Zat-i Ahmadiyyah (asm),  Zat-i Ahmadiyyah (asm),  walâyat-i Ahmadiyyah (asm)
muhammad (peace and blessings be upon him) :   Ahmadiyyah (asm), Muhammad alayhissalâtu wassalâm, Hadrat Muhammad alayhissalâtu wassalâm
muhammad (peace and blessings by upon him) :   Muhammad alayhissalâtu wassalâm,  Zat-i Ahmadiyyah (asm)
muhammad the trustworthy :   Muhammad-ul Amîn, Muhammadu'l-Amîn
muhammad's (pbuh) :   Ahmadiyyah (asm)
muhammad's sainthood :   walâyat-i Ahmadiyyah (asm)
muhammadan :   Muhammadan (asm)
muhammadan (pbuh) :   Muhammadiyyah (asm)
muhammadan being (pbuh) :   Zat-i Ahmadiyyah (asm),  Zat-i Muhammadiyyah (asm)
muhammed the thrustworthy :   Muhammad-ul Amîn
muhyiddin al-'arabi :   Muhyiddîn-i 'Arabî,  Muhyiddîn-i 'Arabî
muhyiddin al-arabi :   Muhyiddîn-i 'Arabî
mujtahid :   mujtahid
mukhâtab :   mukhâtab
multiplicity :   kathrah
munificence :   karam
munificent :   Karîm, Muhsin,  Karîm
munificent provider :   Razzâq-i Karîm
munificent sustainer :   Rabb-i Karîm
munificient :   Karîm
munificient - powerful :   Karîm - Qadîr
musaylima :   Musaylima,  Musaylima
musaylima the liar :   Musaylima-i Kazzâb,  Musaylima-i Kazzâb
mu’azhzham :   mu’azhzham
myself :   nafs,  nafs
mystery of man's accountability :   sirr-i taklîf,  sirr-i taklîf
mystery of oneness :   sirr-i ahadiyyah
mâlik-ul mulk :   Mâlik-ul Mulk
mâlikiyyah :   mâlikiyyah
n all-wise and glorious one :   Hâkim-i Zuljalâl
nafs :   nafs
nafs' :   nafs
naqshi way :   Naqshî tarîqah
narrations :   riwâyahs,  riwâyahs, riwâyah
narrations / sura :   riwâyah / Surah
narrators :   râwî
nass qat’î :   established principle
nation :   ummah,  ummah
necessarily existent :   wujûb-u wujûd , Wâjibu'l-wujûd , Zat-i Wâjibu'l-Wujûd
necessarily existent one :   Wâjib-ul Wujûd,  Wâjibu'l-wujûd , Wâjibu'l-wujûd, Zat-i Wâjibu'l-Wujûd,  Zat-i Wâjibu'l-Wujûd, Wâjibu'l-wujûd
necessarly existent one :   Wâjibu'l-wujûd , Almighty Wâjibu'l-Wujûd
necessary :   wujûb,  wâjib
necessary being :   Wâjibu'l-wujûd
necessary existance :   wujûb-u wujûd
necessary existence :   Wujûb Wujûd,  wujûd-u Wâjib,  wujûb-u wujûd , wujûb,  wujûb-u wujûd , wujûb
necessary existence & necessarily existent one :   Wâjibu'l-wujûd  &  wujûb-u wujûd (ayrı ayrı)
necessary existent :   Wâjibu'l-wujûd
necessary existent one :   Zat-i Wâjibu'l-Wujûd
necessity :   wujûb
negation :   nafy, takdzîb
neglect :   ghaflah
night of power :   Layla-i Qadr, Laylat al-Qadr, layla-i zû-qadr
nightfall :    I'shâ
nimrod :   Yok
no! god forbid :   hâshâ
noah :   Nûh
noah (puh) :   Nûh (as)
noble :   karîm
noble messenger :   Rasûl Akram (A.S.M.)
noble messenger of god :   Rasûl-u Akram
noble messenger's (pbuh) :   Rasûl-i Akram alayhissalâtu wassalâm
noble messenger's (peace and blessings be upon him) :   Rasûl-i Akram alayhissalâtu wassalâm
non-being :   ‘adam
non-existence :   ‘adam,  fanâ
not trusting in you :   without tawakul
nufûs :   nufûs
numerical value :   hasâbu'l-abjad
nurturer :   Murabbî,  Murabbi
o beauteous one of glory :   Yâ Jamîl-i Züljalâl
o beauteous one of perfection :   Yâ Jalîl-i Zülkamâl
o beauteous one! o beauteous one! o most compassionate and merciful one! :   Yâ Jamîl, Yâ Jamîl, Yâ Rahîm, Yâ Rahîm
o bestower of bounties :   yâ Mun'îm
o compassionate one :   Yâ Rahîm
o gentle one :   yâ Hannân
o gentle one! o most merciful one! o most compassionate one! o most generous one! o gracious one! o benevolent one! o giver of forms! o giver of light! o bestower! o adorner! :   Yâ Latîf, Yâ 'Atûf, Yâ Musawwir, Yâ Munawwir, Yâ Muhsin, Yâ Muzayyin
o giver of light! o bestower! o adorner! :   Yâ Munawwir, Yâ Muhsin, Yâ Muzayyin
o glorious one of beauty! :   Yâ Jalîl-i Züljamâl
o glorious one! o glorious one! o one of might :   Yâ Jalîl, Yâ Jalîl, Yâ 'Azîz, Yâ Jabbâr
o god :   Yâ Haqq, Yâ Rabb
o gracious one :   Yâ Latîf
o living one :   Yâ Hayy
o lord :   Labbayk,  Yâ Rabb
o loving one :   Yâ Wadûd
o master :   Assalâmû alayka yâayyuha'l-ustâd
o merciful one :   Yâ Rahmân
o most merciful one! :   Yâ Rahîm
o most merciful one! o provider! :   Yâ Rahmân, Yâ Razzâq
o most patient one! :   Yâ Sabûr
o munificent one :   yâ Karîm
o my creator :   Yâ Khâliqî
o my sustainer :   Yâ Rabb
o our god! amen :    min Allahumma âmin
o our sustainer :   yâ Rabbanâ, Yâ Rabbanâ
o our sustainer! :   Yâ Rabbanâ
o perfect one of beauty :   yâ Kâmil-i Züljamâl
oath of allegiance :   bî'at
obedience :   ‘ubûdiyyâh, tâ’at
object of love :   mahbûb
object of worship :   Ma'bûd,  ma'bûd
object of) worship :   ma'bûd
objet of worship :   Ma'bûd
obligation :   minnah
obligations :   farâidh
obligatory :   fardh, wâjib,  fardh
obligatory practices :   farâidh
observances :   sha'âir
obstinate :   mu'annid
occurence :   wuqû'
occurrence :   wuqû’
of guidance :   Murshid
of mighty stature :    'Azîmushshân,   'Azîmushshân
of miraculous exposition :   Mu'jizu'l-Bayân
offer praise :   offer hamd
offer supplication :   make du'a
offer supplications :   make du'a,  make du'a
offers supplication :   make(s) du'a
officious :   fudûlî
olmuyor :   rubûbiyyah, wird
omnipotent one :   Qadîr-i Mutlaq, Zat-i Qadîr
omnipotent one of glory :   Qadîr-i Zuljalâl
one :   Qadîr, Wâhid,  Wâhid-i Ahad,  wâhid
one absolutely lacking any need :   Mustaghni­i 'Ala'l­itlaq
one all-beautiful :   Jamîl
one all-compassionate and munificent :   Rahîm-i Karîm
one all-knowing of the unseen :    'Allâm-ul Ghuyûb,   'Allâm-ul Ghuyûb
one all-powerful and compassionate :   Qadîr-i Rahîm
one all-wise and all-compassionate :   Hakîm-i Rahîm,  Hakîm-i Rahîm
one all-wise and all-powerful :   Hakîm-i Qadîr
one fit to be worshipped :   Ma'bûd
one knowing of all things :    'Alîm-i Mutlaq
one maker :   Sâni'-i Wâhid
one of glory :   Zat-i Zuljalâl
one of grandeur :   Zat­i Kibriyâ
one of unity :   Wâhid
one possessing absolute power :   Qadîr-i Mutlaq,  Qadîr-i Mutlaq,  Qadîr-i Mutlaq
one powerful :   Qadir
one so generous :   Karîm
one so glorious :   Zat-i Zuljalâl
one so powerful :   Qadîr
one so powerful and glorious :   Qadîr-i Zuljalâl
one sought :   maqsûd
one who acts and has choice :   Fâ'il-i Mukhtâr
one who acts as he wills :   Fa'âlun limâ yurîd
one who fashioned them :   Sâni'
one whom they worship :   Ma'bûd
oneness :   ahadiyyah,  ahadiyyah,  ahadiyyah,  wahdah, ahadiyyah, Ahadiyyah,  ahadiyyah
oneness of his essence :   Ahadiyyat-i Zatiyyah
oneness of the divine essence :   Ahadiyyat-i Zat-i Ilâhiyyah,  Ahadiyyat-i Zatiyyah
oppressed :   mazhlûm
oppression :   zhulm
oppressor :   zhâlim
order :    nizhâm,  intizhâm,  nizhâm,  tanzhîm
orderer :   Munazzim
ordering :   tanzhîm
orderliness :    nizhâm,  intizhâm
orderly :   muntazham
orders :   tarîqah
organizer :   Mudabbir
our master muhammad the trustworthy (peace and blessings be upon him) :   Sayyidinâ Muhammadu'l Amîn Alayhissalâtu Wassalâm
outer :   mulk, Mulk,  malakûtiyyah
outer aspects :   malakût
outer aspects of things :   mulk
outer aspects of things and the aspects which look to their creator :   mulk and malakût
outer dimensions of things and those dimensions that look directly to their creator :   mulk and malakût
owner :   Mâlik , Sâhib
owner of all things :   Mâliku'l-Mulk
owner of day of judgement :   Mâlik-i Yawmi'd-dîn
ox :   sawr,   Sawr
page :   sâhifah
pages :   suhûf
pain :   alam
paradise :   Jannah,  Jannah,  jannat’ul-ma’wâ
paranormal :   khâriq’ul-’âdah
pardon :   istighfâr
particle :   dzarrah
pbuh :   (asm), alayhissalâtu wassalâm, (ASM),  (asm),   (asm), alayhissalâtu wassalâm
peace and blessing be upon him :   alayhissalâtu wassalâm, alayhissalâtu, wassalâm
peace and blessings be upon him :   Alayhissalâtu wassalâm,  alayhissalâtu wassalâm, Alayhissalâtu wassalâm,   alayhissalâtu wassalâm, (asm), sallallahu alayhi wasallam
peace be upon him :   alayhissalâm,  alayhissalâm,   ‘alayhissalâtu wassalâm,  alayhissalâm, (as)
peace be upon them :   alayhimussalâm,   alayhimussalâm
peace be upon you :   Assalâmû alayka yâayyuha'l-ustâd
peculiar :   makhsûs
peculiarity :   khusûsiyyah
peerless creator :   Fâtir-i Bîmisâl, Khallâq-i Bîmisâl
peerless eternally besought one :   Fard-i Samad
peerless one of beauty :   Jamîl
pen of power :   qalam qudrah
peninsula :   jazîrah
people of belief :   ahl îmân
people of faith :   ahl îmân
people of god seek :   ahlullah
people of guidance :   ahl hidâyah
people of misguidance :   ahl dalâlah,  ahl kufr
people of the book :   ahl-i kitâb
perfect belief :   îmân akmal
perfect creator :   Khâliq-i Zulkalmâl
perfection :   kamâlât
peripatetic philosophers :   mashâiyyûn
permanance :   baqâ
permanence :   abadiyyah, sarmadiyyah,  baqâ
permanent :   abadî,  dâimî,  baqî,  sarmadî
permissible :   halâl, mubâh,  halâl
permitted :   fatwa
person :   nafs
person of muhammad :   Zat-i Ahmadiyyah,  Zat-i Muhammadiyyah,  Zat-i Ahmadiyyah
person of muhammad (pbuh) :   Zat-i Ahmadiyyah (asm),  Zat-i Ahmadiyyah (asm)
person of muhammad (peace and blessings be upon him) :   Zat-i Ahmadiyyah alayhissalâtu wassalâm
perspicuous :   Mubîn
perspicuous book :   Kitâb-i Mubîn
petty :   juz'î
pharaoh :   Yok
philosophers :   hukamâ
phrase :   kalâm
pious :   people of taqwa,  Sâlih,   abrâr
pity :   tarahhum
place your trust in allah :   tawakkul
places his trust in him and relies on him :   tawakkul
plant :   nabâtât
pleasurable :   ladzdzatful
pleasure :   ladzdzat, zawq
plenty :   barakah,  mabzhûliyyat
ponder :   make tafakkur
possessor of absolute power :   Qadîr-i Mutlaq,  Qadîr-i Mutlaq,   Qadîr-i Mutlaq
possessor of absolute power and knowledge :   Qadîr-i 'Alîm-i Mutlaq
possessor of absolute riches :   Ghaniyy-i Mutlaq, Ghaniyy-i
possessor of absolute sovereignty :   Hâkim-i Mutlaq
possessor of absolute wisdom :   Hakîm-i Mutlaq
possessor of all dominion :   Mâliku'l-Mulk
possessor of two wings :   zuljanâhayn
post eternal lord :   Hâkim-i Azalî
post eternity :   abad
post-eternal :   abadî,  abad, abadî
post-eternity :   abad,  Abad, abad,  Abad,  abad, abadiyyah
power :   qudrah,  quwwah,  qudrah
power of choice :   ikhtiyâr
powerful :   Qadîr, 'Alîm, Hakîm, Mudabbir,  Qadîr,  Qadîr, Qadir,  Qadîr,  Qadîr
powerful maker :   Sâni’-i Qadîr
powerful one of perfection :   Qadîr-i Zulkamâl
practices :   sunnah
practices of the most noble prophet :   Rasûl-i Akram alayhissalâtu wassalâm
praise :   ta’zîm, hamd, , tahmîdât,  tahmîdiyah, hamd, tahmîdât
praise and thanks :   hamd
praise and thanks be to god :   Alhamdulillâh
praise be to god :   Falillâhilhamd,  Alhamdulillâh
praise of god :   tahmîd
praised :   Mahmûd
praisers :   zâkirs
praises :   tasbihât, tahmîdât-i Rabbâniyyah,  hamds
praises and glorifications :   tasbihât
pray :   make du'a
prayer :   du’â, 'ibâdah,  du’â,  tahajjûd, salât, du'a, Du'a, munâjât, du'as, zikr,  salawâts, salawât, du'a
prayer of forgiveness :   du'a-i maghfirah
prayer-leader :   imâm
prayers :   salât, du'as, du'a
prays :   make(s) du'a,  du'a
pre eternal and post eternal one :   Sultân-i azal and abad
pre eternal ruler :   Mâlik-i Abadî
pre eternity :   azal
pre-eminent philosophers :   hukamâ
pre-eternal :   Azalî,  azalî,  Azalî, azalî, azaliyyah,  azalî, azaliyyah, azal,  azalî, azaliyyah
pre-eternal addresses of the most holy :   azaliyyat-i Subhâniyyah
pre-eternal all-powerful one :   Qadîr-i Azalî,  Qadîr-i Azalî
pre-eternal all-powerful one of glory :   Qadîr-i Azalî-i Zuljalâl
pre-eternal all-wise one :   Hakîm-i Azalî
pre-eternal all-worshipped one :   Ma'bûd-u Azalî
pre-eternal and post-eternal :   azal and abad,  azal & abad (ayrı ayrı),  azalî and abadî
pre-eternal and post-eternal monarch :   Sultân-i azal and abad
pre-eternal beloved :   Mahbûb-u Azalî,  Mahbûb-u Azalî
pre-eternal discourse :   khutbah-i azaliyyah
pre-eternal inscriber :   Naqqâsh-i Azalî, Naqqâsh-i Azal,  Naqqâsh-i Azalî,   Naqqâsh-i Azalî
pre-eternal master :   Ustâd-i Azalî
pre-eternal monarch :   Sultân-i Azalî,  Sultân-i azalî
pre-eternal one :   azalî, Zat-i Azalî
pre-eternal one of power :   Qadîr-i Azalî
pre-eternal ruler :   Hâkim Azalî
pre-eternal sovereign :   Sultân-i azal
pre-eternal speaker :   Mutakallim-i Azalî
pre-eternal sun :   Shams-i Sarmadî, Shams-i Azalî, Shams-i Azal,  Shams-i Azalî
pre-eternal sun and post-eternal sovereign :   Sultân of Shams-i azal and abad
pre-eternal undying one :   Qadîm-i Lamyazal
pre-eternal witness :   Shâhid-i Azalî
pre-eternally all-wise one :   Hakîm-i Azalî,  Hakîm-i Azalî
pre-eternity :   azal,  Azal, azal,  azal, Wâjibu'l-wujûd  - azalîyyah (ayrı ayrı), azaliyyah,  azal, azaliyyah
pre-eternity to post-eternity :   azal & abad (ayrı ayrı)
prescribed prayers :   salât
preservation :   muhâfazhah
preserved tablet :   lawh mahfûzh,  Lawh-i Mahfûz, lawh-i mahfûz,  alwâh-i mahfûzah
preserver :   Hafîzh,  Hafîzh,  Hafîz
pride of all being :   Fakhr-i kâinât
pride of all the worlds (pbuh) :   Fakhr-i 'âlam (asm)
primitive :   badawî
prince of the saints :   Sultânu'l­awliyâ
principles of fiqh :   usûlu'l-fiqh
principles of religion :   usûlu'd-dîn
proclaim :   taqdîs
productive :   barakah
prohibited :   harâm
promise :   wa’ad,  wa'd
properties :   wasf
property :   mulk
prophet :   nabî, rasûl, muhbîr,  nabî, Nabî
prophet (pbuh) :   Ahmadî (asm)
prophet muhammad's ascension :   mi’râj
prophet muhammed :   Zat-i Ahmadiyyah alayhissalâtu wassalâm
prophet's ascension :   mi’râj
prophet's companions :   Ashâb-i Nabî
prophethood :   nubuwwah, Nubuwwah,  nubuwwah, Nubuwwah
prophethood of muhammed :   risâlat muhammadiyyah
prophets :   anbiyâ, rusul, mursalîn, muhbîr,  anbiyâ, Anbiyâ,  anbiyâ, Anbiyâ,  rasûls,  anbiyâ (alayhimussalâm)
prostrating :   sajdah
providence :   razzakiyyah
provider :   Razzâq,  Razzâq
provider of needs :   Qâdiyu’l-Hâjât
providing :   Razzâq, razzâqiyyah,  Razzâq
provision :   rizq,  arzâq
proximity :   aqrabiyyah, qurbiyyah
psalms :   Zabûr
pulpit :   mimbar,  mimbar
punishment :   mujâzât
pure :   munazzah
pure ones :   asfiyâ
purely for the sake of allah :   liwajhillâh
purified ones :   asfiyâ
purified scholars :   asfiyâ,  asfiyâ
purposeless :   'abath
pyhsical :   shahâdah
qadîr dzul jalâl :   Qadîr Dzul Jalâl
qitr :   qitr
qualified to interpret it (mujtahid) :   mujtahid
qualified to interpret the law :   ijtihâd, mujtahid, mujtahidîn
qur'an of miraculous exposition :   Qur'an Mu’jiz-ul Bayân,  Qur'an-i Mu'jizu'l-Bayân, Mu'jizu'l-Bayân,  Qur'an-i Mu'jizu'l-Bayân, Qur’an-i Mu'jizu'l-Bayân
qur'an's verses :   âyat-i karîmah, Qur'an's âyahs
quwwat ma’nawiyyah :   quwwat ma’nawiyyah
quwwat ‘aqliyyah :   quwwat ‘aqliyyah
radiant :   olmuyor
rak'ats :   rak'ah, rak'ah
rasûl akram :   Rasûl Akram
reality :   haqîqat
realm :   ‘âlam, dâr
realm of eternity :   ‘âlam bâqî,  ‘âlam baqâ
realm of seen :   ‘âlam shahâdah
reanimation :   ihyâ
reason :   ‘aql
reasoning :   muhâkamah
rebellion :   ‘isyân
recitation :   zikr,  zikr
recitation of allah's names :   zikr
recitation of god's names :   zikr
recitation of his at outset of their duties :   tasbîh
recitation of the qur'an :   Zamzama-i Qur'an
recitations :   azkâr,  zikr
reciter :   zâkir
reciter of the qur'an :   hâfiz
recollect :   zikr
recollection :   zikr
reflect on :   do tafakkur
reflecting :   tafakkur, making tafakkur
reflecting on :   tafakkur, making tafakkur
reflecting their meanings :   ma'nâ-i harfî
reflection :   fikr, tafakkur,  tafakkur
relation of creator :   khallâqiyyah
relations :   sila-i rahîm
reliance :   tawakkul
reliance on allah :   tawakkul,  tawakkul
reliance on god :   tawakkul
reliance on him :   tawakkul
reliance taught by the shari'a :   tawakkul-u shar'î
religion :   dîn,  usûlu'd-dîn
religious duties :   farâidh
religious obligation :   fardh-i kifâyah
religious obligations :   farâidh,  farâidh
rememberance of god :   zikr,   zikr
remembrance :   zikr,  zikr
repent :   tawbah,  tawbah
repentance :   tawbah, istighfâr
reprehensible :   makrûh
reprehesible :   makrûh
representative :   wakîl,  mumaththil
resurrection :   hashr
resurrector :   Bâ'is
revelation :   wahy,  wahiy,  wahiy,  wahiy
revenge :   intiqâm
revolution :   inqilâb
reward :   mukâfât
righteous :   sulahâ, atqiyâ
righteous acts :   Sâlih 'amal
righteous early generations :   salaf-i sâlihîn,  salaf-i sâlihîn
righteous of his community :   atqiyâ of his ummah
righteousness :   salâhah
risale-i hamidiye :   Risâla-i Hamîdiyyah, Risâla-i Hamidiyyah
root of the tail (the coccyx) :    'Ajbu'z-zanab
ruler :   Mutasarrif,  hâkim, Hâkim, Hâkim,  Hâkim
ruler of pre-eternity and post-eternity :   the Sultân of the azal and abad, Hâkim-i Azal and Abad
rules :   sharî'ah
rumours :   waswasah
sa'd al-din taftazani :   Sa'd-i Taftazânî
sabeans :   Sabiyyûn
sacred :   qudsî, muqaddas
sacred books :   kutûb muqaddasah
sacred law :   sharî'ah,   sharâyi', sharî'ah
sacred laws :   sharî'ahs,  sharî'ahs
sacred mosque :   Masjid-i Harâm
safety :   salâmat
sages :   muhaqqiqîn, mudaqqiq,  hukamâ
saint :   walâyat-i Ahmadiyyah (asm),  waliy, walî, Waliy,  walî, waliy
sainthood :   walâyah,  walâyah, walâyahs, awliyâ,  walâyah
sainthood of muhammad (pbuh) :   walâyat-i Ahmadiyyah (asm)
saintly :   ahl walâyah
saintly guides of those seeking knowledge of god :   awliyâ-i ‘ârifîn
saints :   awliyâ,  the people of walâyah, walâyah, waliys, awliyâ, people of walâyah, walî,  waliys, Awliyâs, people walâyah, walâyah, walî
saints known as abdal :   abdâls
sake of god :   lillâh
sakkaki :   Sakkakî
salsabil :   salsabîl, Salsabil
saltanât sarmadî :   Saltanât Sarmadî
salutations :   tahiyyât,  tahiyyahs, tahiyyah
sameness :   wâhidiyyah
samâwât and ‘ard :   samâwât and ‘ard
satan :   Shaytân
satanic whisperings :   lumma-i shaytâniyyah
sayyid sharif al-jurjani :   Sayyid Sharif al-Jurjani
sa’âdat ‘ûzhmâ :   sa’âdat ‘ûzhmâ
scale :   mîzân
sceptic :   waswasah
sceptical :   waswasah
scholar :   'âlim
scholars :   muhaqqiq, muhqqiqs, muhaqqiqîn, imâm,  ‘ulamâ
scholars of related hadiths :   muhaddisîn-i muhaddasûn
scholars of religion :   muhaqqiqîn
scholars of the prophetic hadiths :   muhaddisîn
scholars of theology :   mutakallimîn,  mutakallimîn
scholars of theology (kalâm) :   mutakallimîn
school :   mazhab,  mazhab,  mazhab
school of law :   mazhab
school of thought :   mazhab
schools :   mazhabs, mazhab, mazhabî
schools of law :   mazhabs, mazhab,  mazâhib, mazhabs
science of jurisprudence :    'ilm-i usûl
science of method :    'Ilm-i usûl,   'ilm-i usûl
science of religion and philosophy :    'ilm-i usûl
sciences :   'ulûm
sciences of rhethoric :    'ilm-i bayân
sciences of the principles of religion :   usûlu'd-dîn
scribe :   kâtib
scriptures :   suhûf
scruple :   waswasah
scruples :   waswasah
seal :   Khâtam
seal of the prophets :   Khâtamu'l­Anbiyâ
seat of dominicality :    'arsh-i rubûbiyyah
seed :  habbah
seeing :   Basîr
seek guidance :   istikhârah
seeking of forgiveness :   istighfâr,  tawbah
self :   nafs
self-necessitating :   mû'jib-i bizzat
self-subsistent :   Qayyûm,  Qayyûm,   Zat-i Hayy-i Qayyûm
self-subsistent one :   Qayyûm,  Qayyûmiyyah
sense of taste :   quwwat dzâiqah
sequence of thought :   tafakkur
sermon :   khutbah,  khutbah
servants :   ‘ibâd,  'ibâd
service :   khidmat
set of rules of his creation :   sharî'at-i fitriyyah
seven hanging poems :   Mu'allaqât-i Sab'ah
sha'rani's mizan :   Sha'rani's Mizan
shafi'i :   Shafi'î,  Shafi'î
shah geylani :   Shâh-i Gaylânî
shah naqshband :   Shâh-i Naqshiband
sharh al-maqasid :   Sharhu'l-l Maqâsid
sharh al-mawaqif :   Sharhu'l-Mawâqif,  Sharhu'l-l Mawâkif
shari'a :   sharî'ah, shar'î, Shâri', Sharî'ah, sha'âir,  sharî'ah, shar'î
shari'a of creation :   SHARÎ'AT-I FITRIYYAH,   greater sharî'ah, the sharî'ah of creation
shari'a of muhammad :   shar'-i Ahmadî
shari'ah of muhammad :   sharî'at-i Ahmadiyyah
sharî'ah :   rukhsah
shaykh geylani :   Shaykh-i Gaylânî
shuûnât :   shuûnât
shuûnât ilâhiyyah :   Shuûnât Ilâhiyyah
sifât qudsiyyah :   Sifât Qudsiyyah
signifying something other than themselves :   ma'nâ-i harfî
signifying themselves :   ma'nâ-i ismî
signs :   âyât, âyah
signs of his dominicality :   the signs of His rubûbiyyah
signs of the dominicality :   signs of the Rabbâniyyah
similitudes :   misâl, misâliyyah
sin :   zhulm
sincere :   Ikhlâs,  khâlis
sincerity :   Ikhlâs,  sadâqah, ikhlâs
single :   Zat-i Ahad-i Samad,  Wâhid-i Ahad,  Ahad
single and eternally besought one :   Zat-i Ahad-i Samad, Zat-i Ahad and Samad,  Zat-i Ahad-i Samad
single and most pure and holy essence :   Zat-i Aqdas
single and unique :   Wâhid-i Ahad,  Wâhid-i Ahad
single and unique one :   Zat-i Ahadiyyah,  Wâhid-i Ahad
single necessarily existent one :   Zat-i Wâjibu'l-Wujûd,  Wâjibu'l-wujûd
single one of unity :   wâhid-i Ahad, Wâhid-i Ahad,  Wâhid-i Ahad,  Wâhid-i Ahad
single one of unity7 :   wâhid-i Ahad
singleness :   fardâniyyah
sinners :   fujjâr
sirat :   sirât
skills :   ma'rifah
so certainly it is at the degree of 'absolute certainty' :   haqqalyaqîn
solicitous :   shafqat-ful
solicitousness :   Shafqah
solicitude :   Shafqah
solomon :   Sulaymân,  Sulaymân
solomon (peace be upon him) :   Sulaymân alayhissalâm
solomon's hoopoe :   Hudhud-u Sulaymânî
sons of adam :   sons of  dam
sorcery :   sihr
sorrow :   alam
sought :   Maqsûd
soul :   rûh, nafs,  nafs,  nafs, nafsâniyyah, nafs', nafsî, nafsânî,  nafs
souls :   nufûs, nafs', nafs,  nafs, nafs'
sound :   sahîh
sound narrations :   riwâyat-i sâdiqah
sovereign :   Sultân,  rubûbiyyah
sovereign of eternity :   Sultân Sarmadî
sovereign of pre-eternity and post-eternity :   Hakîm-i azal and abad, the Sultân of the azal and abad, Sultân-i azalî and abadî
sovereign so glorious :   Mâlik-i Zuljalâl
sovereignty :   Saltanât,  Saltanât,  ulûhiyyah
sovereignty of dominicality :   Saltanât Rubûbiyyah
speaker :   Mutakallim
species :  naw'
speech :   kalâm
sperm :   nutfah
spirit :   rûh, nafs,  nufûs
spirit being :   rûhânî
spiritual :   ma’nawî
spiritual journey :   sayr-u sulûk, sayr u sulûk
spiritual poles of the lovers of god :   aqtâb-i ‘âshiqîn
spiritual radiance :   faydh
spiritual voyaging :   sayr ü sulûk­u walâyah
spirituality :   ma’nawîyyât
splendour :   jalâl,  'izzat
splitting of the moon :   Shaqq Qamar,  inshiqâq Qamar
steadfastness :   matânah
steed :   burâq, Burâq
stoop :   tanazzul
straight path :   sirât-i mustaqîm,  sirât-i mustaqîm
strength :   quwwat
strong but imitative :   taqlîdî
suaât-i mârifeti'n-nebi :   shu'â'ât-i Ma'rifati'n-Nabi
subduer :   Qahhâr,  Qahhâr
subduer of the sun :   Hakîm-i Zulkamâl
subjugate :   make musakhkhar
subjugated :   musakhkhar
sublime maker :   Sâni'-i Zuljalâl
sublime sustainer :   Rabb-i 'Azîm
sublime throne :    ‘arsh-i a'zam,  'arsh-i a'zam,  ‘arsh
submission :   taslîm
submissive :   musakhkhar
substitutes :   abdal
subtle :   latâif, latîf
subtle dominical faculty :   latîfat-i Rabbâniyyah
subtle exquisiteness :   latâif
subtle faculties :   latîfa, Rabbâniyyah, sirr, latâif,  latâif, latîfahs
subtle faculty :   latîfa-i Rabbâniyyah, latîfahs
subtle inner faculties :   latâif
subtle instances :   latâif
subtle qualities :   latâif
subtle senses :   latâif
subtle senses and faculties :   latâif
subtle woders :   latâif
subtle wonders :   latâif
subtleties :   latâif
succourer :   Mughîs
sufi paths :   tarîqahs,  tarîqahs
sufi way :   tarîqah
sufis :   mutasawwifîn
sufism (tariqat) :   tarîqah
sufyan :   Mahdi, Sufyân,  Sufyân,  Sufyân
sufyan ibn uyayna :   Sufyân ibn-i 'Uyaynah,  Sufyân, Ibn-i 'Uyaynah
suggestion :   waswasah
suggestions :   waswasah
sultan :   Sultân
sultân dzul jalâl :   Sultân Dzul Jalâl
sultân dzî shân :   Sultân Dzî Shân
summon :   da’wah,  da’wah
summons :   du'a,  da’wah
sun :   shams
sun of divine oneness :   Shams-i Ahadiyyah
sun of miraculous exposition :   Shams-i Mu'jiz-bayân
sun of pre-eternity and post-eternity :   Shams-i azal and abad,   Shams-i azal and abad
sun of prophethood :   Shams-i Nubuwwah
sun of suns :   Shamsu'sh-Shumûs
sunna :   sunnah,  sunnat-i saniyyah,  sunnah
sunni :   Ahl-i Sunnah wal Jamâ'ah, Ahl-i Sunnah
sunni school :   Ahl-i Sunnah wal Jamâ'ah
sunnis :   Ahl-i Sunnah wal Jamâ'ah
sunset :   maghrib
suplicate :   make du'a
suplication :   munâjât
suplications :   du'as
supplicate :   make du'a
supplication :   munâjât,  du’â,  Munâjât,  MUN J T,  du'a, , make du'a, munâjât, du'as,  du'a, munâjât, mubârak munâjât, du'as
supplications :   munâjât, du'a,  du'as
supposing :   tawahhum
supreme :   kubrâ,  akbar, a’zham
supreme sainthood :   walâyat-i kubrâ
supreme throne of god :    'arsh
supreme trust :   amânah
sura :   Surah, surah,  surah
sura al-fath :   Surah al-Fath
sura al-fatiha :   Fâtihah, Fatiha-i Sharîfah,  Surah al-Fâtihah
sura al-ikhlas :   Surah al-Ikhlâs,  Surah al-Ikhlâs
sura al-kafirun :   Surah Qul yâ ayyuha'l-kâfirûn
sura al-mursalat :   Surah al-Mursalât
sura al-nur :   Surah an-Nûr
sura al-rahmân :   Surah ar-Rahmân
sura al-zilzal :   Surah Iza zulzilati'l-ardhu
sura tı sin mim :   Surah ti sîn mîm
sura ya. sin. :   Surah Yâsîn, surah Yâsîn , Yâsîn-i Sharîf
sura yusuf :   Surah Yûsuf
surah al-ikhlas :   Surah al-Ikhlâs
suras :   surahs, Surahs,  Surah al-Ikhlâs'
suspicion :   waswasah
suspicions :   waswasah
sustainer :   Rabb,  Rabb,  Rabb, Rabbâniyyah, rubûbiyyah, Rabbânî,  Rabb, rubûbiyyah, Rabbâniyyah,  Rabb,   Rabb
sustainer of all the worlds :   Rabbu'l-'âlamîn,  Rabbu'l-'âlamîn
sustainer of all the worlds-godhead :   Rabbu'l-'âlamîn - ulûhiyyah
sustainer of all-worlds :   Rabbu'l-'âlamîn
sustaining :   Rabbâniyyah
sustaining dominicality :   rubûbiyyah
sustaining of his creatures :   rubûbiyyah
sustenance :   rizq,  arzâq
sâdiq :   sâdiq
sâdiqu'l-wa'dil karîm :   Sâdiqu'l-Wa'dil Karîm
sâni’ dzul jalâl :   Sâni’ Dzul Jalâl
sıfat :   sıfat
tablet :   Lawh,  lawh, alwâh
tablet of effacement and reaffirmation :   Lawh-i Mahw Isbât
tablet of effacement of reaffirmation :   Lawh-i Mahw Isbât
tanwin :   tanwîn
taqdîs :   taqdîs
taqwa :   taqwâ,  taqwâ, taqwa
tarawih :   tarawîh
tariqat :   tarîqah
tasdîq :   tasdîq
teacher :   mu'allim
teaching :   dars, tarbiyyah,  ta’lîm
ten intellects :    'uqûl-u 'asharah
tenets :    'aqâid
tesbihat :   tasbihât,  tasbihât
tesettür :   Hijâb
testify :   make shahâdah
testimony :   shahâdah,  shahâdah
thanked :   Mashkûr
thanks :   shukr, hamd
thanks be to god :   alhamdulillâh
that affords absolute certainty :    'aynalyaqîn
that appeared before the beginning of his mission :   irhâsât
that he is one in essence :   Ahadiyyat-i zatiyyah
that in jerusalem :   Masjid-i Aqsâ
their apparent faces :   mulk
their aspects that look directly to himself :   malakût
their existence is impossible :   mumtani'atun bizzât
their inner aspects which look to him :   malakût
theologians :    'ilm-i kalâm
theology :   kalâm, usûlu’d-dîn, usûl-u kalâmiyyah,  'aqâid-i kalâmiyyah, usûl-u dîn,  'ilm-i kalâm, usûl-u kalâmiyah,   'ilm-i kalâm, kalâm
theology (kalâm) :   kalâm
theology and belief :    'aqâid-i kalâmiyyah
there is no 'he' but he :   Lâ Huwa Illâ Hû
there is no creator save he! :   Lâ Khâliqa Illâ Hû
there is no existent but he :   Lâ Mawjûda Illâ Hû
there is no god but he! :   Lâ Ilâha Illâ Hû
there is no need for partners :   mustaghniyatun 'anha
there is no self-subsistent save he :   Lâ Qayyûma Illâ Hû
there is nothing fit to be worshipped save he! :   Lâ Ma'bûda Illâ Hû
things seen :   mubsirât
those recite god's praises :   hâmids
those seeking knowledge of god :    'ârifs
those who acknowledge it :   muwahhid
those who fear god :   taqwa
those who investigated them :   muhaqqiqîn
those who recite god's names :   zâkirs
those who think and contemplate :   ahl-i tafakkur
thought :   tafakkur,  tafakkur,  fikr
thought and reflection :   tafakkur
thoughtful :   mutaffakkir
threat :   wa'îd
throne :    'arsh-i rubûbiyyah,  'arsh,  ‘arsh ,  ‘Arsh,   ‘arsh,   ‘Arsh ,  ‘arsh
throne of all-merciful one :    ‘Arsh-ur Rahmân
throne of divine knowledge :    'arsh-i mârifatullah
throne of his dominicality :    'arsh of His rubûbiyyah
throne of sustenance :   Razzâqiyyah & 'arsh (ayrı ayrı)
throne of the all-merciful one :    'arsh-i Rahmân
throne of the sustainer of all the worlds :   Rabbu'l-'âlamîn - 'arsh
through the outside world :   sayr-i âfâqî
to be rabb :   to be Rabb
to interpret the law :   ijtihâd
to liken themselves to the necessary being :   tashabbuh-u bi'l-Wâjib
tongue of disposition :   lisân hâl
torah :   Tawrât,  Tawrât
torment :   ‘adzâb,  ta’dzîb
transcendent :   munazzah
transformation :   tahawwulât
transgression :   zhalûmiyyah
transience :   fanâ
transient :   fânî,  fânî
translator :   tafsîr
transparency :   shaffâfiyyah
treacherous :   zhâlim
treatise :   risale
tree :   shajarah,  darî'
tree of hell :   zaqqûm
tree of paradise :   tûba
trial :   taklîf
true :   haqq, haqîqî,  haqq
true beloved :   Mahbûb-u Haqîqî, mahbûb,  Mahbûb-u Bi'l-Haqq
true bestower :   Almighty Mun'im-i Haqîqî, Mun'im-i Haqîqî
true bestower of bounties :   Mun'im-i Haqîqî, Qayyûm-u Bâqî,  Mun'im-i Haqîqî
true desired one :   maqsûd
true disposer :   Mutasarrif-i Haqîqî
true effective agent :   Muassir-i Haqîqî
true giver of existence :   Mûjid-i Haqîqî
true god :   Haqq
true knowledge :   ma'rifah
true object of worship :   Ma'bûd,   Ma'bûd-u Haqîqî, Ma'bûd, Ma'bûd-u Bi'l-haqq, ma'bûd
true owner :   Mâlik-i Haqîqî
true provider :   Razzâq-i Haqîqî,  Razzâq-i Haqîqî
true sought one :   matlûb
truly devout :   taqwâ
truly existent one :   Mawjûd-u Haqîqî
truly just one :    'âdil-i Bi'l-haq
trumpet :   Sûr
trumpet-blast :   Sûr
trust :   amânah,  anâniyyah, amânah,  amânah,  amânah
trust in god :   make tawakkul, Tawakkul
trust in him :   tawakkul
truth :   haqq, haqîqî,  haqîqat,  Haqq, Al-Haqq,  Haqq,  Haqq
truth (all glory be unto him and may he be exalted) :   Haqq Subhânahu wa Ta'âlâ
truthful :   sâdiq
truthfulness :   sidq,  haqqâniyyat
truths of belief :   haqâiq îmâniyyah
tuba :   tûba
tuba-tree :   tûba, tûba-tree
two-faced trouble-maker :   munâfiq
ultimate fate :   âqibat
umma :   Ummah, ummah
unbelief :   kufr
unbeliever :   kâfir
unbelievers :   kâfirs,  ahl kufr,  kuffâr
uncleanness :   najâsat
unconscious :   ghayr-i shu’ûr,  shu’ûrless
undeniably :   bi'ilmalyaqîn
undisputed narrations :   tawâtur
undying beauty of his essence :   Jamîl-i Bâqî
undying beloved :   Mahbûb-u Lâyazâl, Mâ'shûq-u Lâyazâlî, Mahbûb-u Lâyazalî
undying creator :   Khâliq-i Lamyazal,  Khallâq-i Lamyazal
undying object of worship :   Ma'bûd-u Lamyazal
unique and eternally besought one :   Ahad-i Samad
unique and single one :   Zat-i Ahad, Zat-i Ahadiyyah,  Zat-i Ahadiyyah
unique being :   Dzât  Wâhid
unity :   wahdâniyyah,  wahdah,  wâhidiyyah, wahdah, wahdâniyyah, WAHDAH,  wahdah, wahdâniyyah,  wahdâniyyah, tawhîd, wahdah, ahadiyyah, wâhidiyyah,  wahdah, wahdâniyyah, wâhidiyyah, tawhîd,  ittifâq
unity of almighty god's person :   wahdat-i shakhsiyyah
unity of existence :   wahdatu'l-wujûd
unity of existence' :   wahdatu'l-wujûd
unity of his dominicality :   wahdat-i rubûbiyyah
unity of oneness :   wahdat-i ahadiyyah
unity of the most merciful :   tawhîd-i Rahmân
unity of their sustainer :   wahdâniyyat-i Rabbâniyyah
unity of witnessing :   wahdatu'l-shuhûd
universal :   kullî,  'umûmî
universal wisdom :   hikmat ‘âmmah
universe :   kâinât
unlawful :   harâm,  harâm
unlawfulness :   unlawfulness (harâm)
unlettered :   ummî, Ummî
unlikelihood :   istib’âd
unproductive :   without barakah
unseen :   ghayb,  ghayb, ghaybî,  ghayb,  ghayb, ghaybî,  ghaybiyyah, ghaybî
untaught :   ummî
unveiler :   kashshâf
unveiling :   kashf,  kashf
upon whom be blessings and peace :   ‘alayhissalâtu wassalâm,  A.S.M.
upon whom be peace and blessings :   ‘alayhissalâtu wassalâm
upon whom be the best of blessings and most perfect peace :   alayhi afdalu'ssalâti wa akmalu'ssalâm
upright (the upright) :   salâhah
usual practice :   'âdat
utmost :   kamâl
utter certainty :    'aynalyaqîn , haqqalyaqîn
utterly certain :    'aynalyaqîn
utterly self-sufficient :   Ghaniyy-i Mutlaq
uveysu'l-qarani :   Uwaysa'l-Qarânî
vahid :   wâhid
vain :   ‘abath
vanity :   ‘abathiyyah
various formulas :   azkâr
vast :   azhîm
veracious :   siddîqîn, sâdiq
veracious scholars :   muhaqqiq,  ahl tahqîq
veracity :   haqqaniyyâh,  sidq
verse :   âyah,  âyah,  yah, âyât, âyat-i karîmah,  âyah, âyat-i karîmah
verses :   âyât,  âyahs,   yah,  yahs, âyahs, âyah, âyât, âyâhs,  YAH,  âyah, âyât, âyahs
verses of that distinguisher :   âyât-i Furqâniyyah
vice :   safâhat
vicegerent :   khalîfah
vicegerent of allah :   khalîfah
vision :   ru'yah, shuhûd,  ru'yah
vision of certainty :    'aynalyaqîn,   'aynalyaqîn
vision of divine beauty :   ru'yat-i jamâlullah
voices of the unseen :   hâtif
wastefulness :   isrâf
wazhîfat fitriyyah :   wazhîfat fitriyyah
we affirm it :   Saddaqnâ
we believe in it :    mannâ
weak :   daîf,  ‘âjiz,  ‘âjiz
weakness :   ‘ajz
well-ordered :   muntazham
what blessings god has bestowed :   Bârakallah
what wonders allah has willed! how great are allah's blessings :   Mâshâallah, Bârakallah
what wonders god has willed :   Mâshâallah, mâshâallah
whisperer :   muwaswis
who believe in one god :   ahl-i tawhîd
whole muslim community :   ummah
wicked :   ashrâr
will :   ikhtiyâr,  ikhtiyâr, irâdah,  mashîah,  mashîah
winged :   zi'l-ajniha
winning god's love :   mahbûbiyyah
wisdom :   hikmah
wise :   Qadîr, 'Alîm, Hakîm, Mudabbir,  Hakîm,  Hakîm,  Hakîm,  hikmatful
wise creator :   Fâtir-i Hakîm
wise maker :   Sâni'-i Hakîm
wise qur'an :   Hakîm
wise qur’an :   Qur’an Hakîm
wise reason :   hikmah
wise ruler :   Mutasarrif Hakîm
wisperings :   waswasahs
with all certainty :   bi'aynalyaqîn
with such absolute certainty :   bihaqqalyaqîn
witness :   shâhid
witnessing :   shuhûd
wonder :   karâmah
wonder-working :   karâmah
word of god :   kalâmullâh,   kalâmullâh, Kalâm-i Ilahî, kalimatullah,  kalâmullâh
words of glorification :   tasbîhiyah
words of the narrators of hadith :   ahâdîs-i sharîfah
works :   âthâr
world :   ‘âlam, dunyâ,  ‘âlam, dâr
world of hereafter :   ‘âlam baqâ, ‘âlam âkhirah,   ‘âlam baqâ, ‘âlam âkhirah
world of islam :   ‘âlam Islam
world of meaning :    'âlam-i ma'nâ,    'âlam-i ma'nâ
world of similitudes :    'âlam-i mîsâl,    'âlam-i mîsâl
world of spirits :   ‘âlam  arwah,   'âlam-i arwâh,   ‘âlam  arwah,   'âlam-i arwâh
world of the hereafter :   ‘âlam baqâ, ‘âlam âkhirah
world of the seen :   'âlam shahâdah,   'âlam shahâdah
world of the spirits :   ‘âlam  arwah
world of the unseen :   ‘âlam  ghayb
world of unseen :   ‘âlam  ghayb,   ‘âlam  ghayb
worldly :   dunyawî
worldly life :   hayât dunyawiyyah
worlds of the unseen :    'âlam-i ghayb
worship :   ‘ubûdiyyâh, 'ibâdah,  ‘ubûdiyyâh, tâ’at
worshipped :   taqdîsât
worshipped one :   Mahbûb-u Bâqî
ya. sin :   Yâsîn, Surah Yâsîn
zakat :   zakât,  zakât
zakkum-tree :   zaqqûm
zamakhshari :   Zamakhsharî
zaqqum :   zaqqûm,  zaqqûm
zemzem :   zamzam